new_loan_id,payment_no,principal,installment,interest,payment_due_date
1000013848,1,0,315,315,05-12-2020
1000013848,2,0,315,315,05-01-2021
1000013848,3,0,315,315,05-02-2021
1000013848,4,0,315,315,05-03-2021
1000013848,5,0,315,315,05-04-2021
1000013848,6,0,315,315,05-05-2021
1000013848,7,1975,2290,315,05-06-2021
1000013848,8,2035,2290,255,05-07-2021
1000013848,9,2096,2290,194,05-08-2021
1000013848,10,2159,2290,131,05-09-2021
1000013848,11,2221,2288,67,05-10-2021
1000013849,1,961,1217,256,05-12-2020
1000013849,2,990,1217,227,05-01-2021
1000013849,3,1019,1217,198,05-02-2021
1000013849,4,1050,1217,167,05-03-2021
1000013849,5,1081,1217,136,05-04-2021
1000013849,6,1114,1217,103,05-05-2021
1000013849,7,1147,1217,70,05-06-2021
1000013849,8,1182,1217,35,05-07-2021
1000013850,1,0,258,258,05-12-2020
1000013850,2,0,258,258,05-01-2021
1000013850,3,0,258,258,05-02-2021
1000013850,4,0,258,258,05-03-2021
1000013850,5,0,258,258,05-04-2021
1000013850,6,0,258,258,05-05-2021
1000013850,7,4232,4490,258,05-06-2021
1000013850,8,4360,4491,131,05-07-2021
1000013851,1,957,1212,255,05-12-2020
1000013851,2,985,1212,227,05-01-2021
1000013851,3,1015,1212,197,05-02-2021
1000013851,4,1045,1212,167,05-03-2021
1000013851,5,1077,1212,135,05-04-2021
1000013851,6,1109,1212,103,05-05-2021
1000013851,7,1142,1212,70,05-06-2021
1000013851,8,1180,1214,34,05-07-2021
1000013852,1,1479,1569,90,05-12-2020
1000013852,2,1523,1569,46,05-01-2021
1000013853,1,895,1276,381,05-12-2020
1000013853,2,922,1276,354,05-01-2021
1000013853,3,950,1276,326,05-02-2021
1000013853,4,978,1276,298,05-03-2021
1000013853,5,1007,1276,269,05-04-2021
1000013853,6,1038,1276,238,05-05-2021
1000013853,7,1069,1276,207,05-06-2021
1000013853,8,1101,1276,175,05-07-2021
1000013853,9,1134,1276,142,05-08-2021
1000013853,10,1168,1276,108,05-09-2021
1000013853,11,1203,1276,73,05-10-2021
1000013853,12,1235,1272,37,05-11-2021
1000013854,1,0,261,261,05-12-2020
1000013854,2,0,261,261,05-01-2021
1000013854,3,0,261,261,05-02-2021
1000013854,4,0,261,261,05-03-2021
1000013854,5,0,261,261,05-04-2021
1000013854,6,0,261,261,05-05-2021
1000013854,7,8706,8967,261,05-06-2021
1000013855,1,1812,2584,772,05-12-2020
1000013855,2,1867,2584,717,05-01-2021
1000013855,3,1923,2584,661,05-02-2021
1000013855,4,1980,2584,604,05-03-2021
1000013855,5,2040,2584,544,05-04-2021
1000013855,6,2101,2584,483,05-05-2021
1000013855,7,2164,2584,420,05-06-2021
1000013855,8,2229,2584,355,05-07-2021
1000013855,9,2296,2584,288,05-08-2021
1000013855,10,2365,2584,219,05-09-2021
1000013855,11,2436,2584,148,05-10-2021
1000013855,12,2511,2586,75,05-11-2021
1000013856,1,0,194,194,05-12-2020
1000013856,2,0,194,194,05-01-2021
1000013856,3,0,194,194,05-02-2021
1000013856,4,0,194,194,05-03-2021
1000013856,5,0,194,194,05-04-2021
1000013856,6,0,194,194,05-05-2021
1000013856,7,2096,2290,194,05-06-2021
1000013856,8,2159,2290,131,05-07-2021
1000013856,9,2223,2290,67,05-08-2021
1000013857,1,1151,1741,590,05-12-2020
1000013857,2,1185,1741,556,05-01-2021
1000013857,3,1221,1741,520,05-02-2021
1000013857,4,1258,1741,483,05-03-2021
1000013857,5,1295,1741,446,05-04-2021
1000013857,6,1334,1741,407,05-05-2021
1000013857,7,1374,1741,367,05-06-2021
1000013857,8,1415,1741,326,05-07-2021
1000013857,9,1458,1741,283,05-08-2021
1000013857,10,1502,1741,239,05-09-2021
1000013857,11,1547,1741,194,05-10-2021
1000013857,12,1593,1741,148,05-11-2021
1000013857,13,1641,1741,100,05-12-2021
1000013857,14,1694,1743,49,05-01-2022
1000013858,1,0,185,185,05-12-2020
1000013858,2,0,185,185,05-01-2021
1000013858,3,0,185,185,05-02-2021
1000013858,4,0,185,185,05-03-2021
1000013858,5,0,185,185,05-04-2021
1000013858,6,0,185,185,05-05-2021
1000013858,7,1991,2176,185,05-06-2021
1000013858,8,2051,2176,125,05-07-2021
1000013858,9,2112,2175,63,05-08-2021
1000013859,1,1589,2705,1116,05-12-2020
1000013859,2,1637,2705,1068,05-01-2021
1000013859,3,1686,2705,1019,05-02-2021
1000013859,4,1736,2705,969,05-03-2021
1000013859,5,1788,2705,917,05-04-2021
1000013859,6,1842,2705,863,05-05-2021
1000013859,7,1897,2705,808,05-06-2021
1000013859,8,1954,2705,751,05-07-2021
1000013859,9,2013,2705,692,05-08-2021
1000013859,10,2073,2705,632,05-09-2021
1000013859,11,2135,2705,570,05-10-2021
1000013859,12,2199,2705,506,05-11-2021
1000013859,13,2265,2705,440,05-12-2021
1000013859,14,2333,2705,372,05-01-2022
1000013859,15,2403,2705,302,05-02-2022
1000013859,16,2475,2705,230,05-03-2022
1000013859,17,2550,2705,155,05-04-2022
1000013859,18,2625,2701,76,05-05-2022
1000013860,1,1796,2413,617,05-12-2020
1000013860,2,1849,2413,564,05-01-2021
1000013860,3,1905,2413,508,05-02-2021
1000013860,4,1962,2413,451,05-03-2021
1000013860,5,2021,2413,392,05-04-2021
1000013860,6,2082,2413,331,05-05-2021
1000013860,7,2144,2413,269,05-06-2021
1000013860,8,2208,2413,205,05-07-2021
1000013860,9,2275,2413,138,05-08-2021
1000013860,10,2339,2409,70,05-09-2021
1000013861,1,1108,1489,381,05-12-2020
1000013861,2,1141,1489,348,05-01-2021
1000013861,3,1175,1489,314,05-02-2021
1000013861,4,1211,1489,278,05-03-2021
1000013861,5,1247,1489,242,05-04-2021
1000013861,6,1284,1489,205,05-05-2021
1000013861,7,1323,1489,166,05-06-2021
1000013861,8,1363,1489,126,05-07-2021
1000013861,9,1404,1489,85,05-08-2021
1000013861,10,1444,1487,43,05-09-2021
1000013862,1,0,744,744,05-12-2020
1000013862,2,0,744,744,05-01-2021
1000013862,3,0,744,744,05-02-2021
1000013862,4,0,744,744,05-03-2021
1000013862,5,0,744,744,05-04-2021
1000013862,6,0,744,744,05-05-2021
1000013862,7,2441,3185,744,05-06-2021
1000013862,8,2514,3185,671,05-07-2021
1000013862,9,2590,3185,595,05-08-2021
1000013862,10,2667,3185,518,05-09-2021
1000013862,11,2747,3185,438,05-10-2021
1000013862,12,2830,3185,355,05-11-2021
1000013862,13,2915,3185,270,05-12-2021
1000013862,14,3002,3185,183,05-01-2022
1000013862,15,3094,3186,92,05-02-2022
1000013863,1,916,1160,244,05-12-2020
1000013863,2,943,1160,217,05-01-2021
1000013863,3,971,1160,189,05-02-2021
1000013863,4,1001,1160,159,05-03-2021
1000013863,5,1031,1160,129,05-04-2021
1000013863,6,1061,1160,99,05-05-2021
1000013863,7,1093,1160,67,05-06-2021
1000013863,8,1130,1164,34,05-07-2021
1000013864,1,2796,3542,746,05-12-2020
1000013864,2,2880,3542,662,05-01-2021
1000013864,3,2966,3542,576,05-02-2021
1000013864,4,3055,3542,487,05-03-2021
1000013864,5,3147,3542,395,05-04-2021
1000013864,6,3241,3542,301,05-05-2021
1000013864,7,3339,3542,203,05-06-2021
1000013864,8,3441,3543,102,05-07-2021
1000013865,1,0,750,750,05-12-2020
1000013865,2,0,750,750,05-01-2021
1000013865,3,0,750,750,05-02-2021
1000013865,4,0,750,750,05-03-2021
1000013865,5,0,750,750,05-04-2021
1000013865,6,0,750,750,05-05-2021
1000013865,7,3866,4616,750,05-06-2021
1000013865,8,3982,4616,634,05-07-2021
1000013865,9,4101,4616,515,05-08-2021
1000013865,10,4224,4616,392,05-09-2021
1000013865,11,4351,4616,265,05-10-2021
1000013865,12,4480,4614,134,05-11-2021
1000013866,1,0,230,230,05-12-2020
1000013866,2,0,230,230,05-01-2021
1000013866,3,0,230,230,05-02-2021
1000013866,4,0,230,230,05-03-2021
1000013866,5,0,230,230,05-04-2021
1000013866,6,0,230,230,05-05-2021
1000013866,7,2476,2706,230,05-06-2021
1000013866,8,2551,2706,155,05-07-2021
1000013866,9,2628,2707,79,05-08-2021
1000013867,1,1353,2171,818,05-12-2020
1000013867,2,1393,2171,778,05-01-2021
1000013867,3,1435,2171,736,05-02-2021
1000013867,4,1478,2171,693,05-03-2021
1000013867,5,1523,2171,648,05-04-2021
1000013867,6,1568,2171,603,05-05-2021
1000013867,7,1615,2171,556,05-06-2021
1000013867,8,1664,2171,507,05-07-2021
1000013867,9,1714,2171,457,05-08-2021
1000013867,10,1765,2171,406,05-09-2021
1000013867,11,1818,2171,353,05-10-2021
1000013867,12,1873,2171,298,05-11-2021
1000013867,13,1929,2171,242,05-12-2021
1000013867,14,1987,2171,184,05-01-2022
1000013867,15,2046,2171,125,05-02-2022
1000013867,16,2110,2172,62,05-03-2022
1000013868,1,0,363,363,05-12-2020
1000013868,2,0,363,363,05-01-2021
1000013868,3,0,363,363,05-02-2021
1000013868,4,0,363,363,05-03-2021
1000013868,5,0,363,363,05-04-2021
1000013868,6,0,363,363,05-05-2021
1000013868,7,2892,3255,363,05-06-2021
1000013868,8,2979,3255,276,05-07-2021
1000013868,9,3068,3255,187,05-08-2021
1000013868,10,3161,3256,95,05-09-2021
1000013869,1,0,948,948,05-12-2020
1000013869,2,0,948,948,05-01-2021
1000013869,3,0,948,948,05-02-2021
1000013869,4,0,948,948,05-03-2021
1000013869,5,0,948,948,05-04-2021
1000013869,6,0,948,948,05-05-2021
1000013869,7,3555,4503,948,05-06-2021
1000013869,8,3661,4503,842,05-07-2021
1000013869,9,3771,4503,732,05-08-2021
1000013869,10,3884,4503,619,05-09-2021
1000013869,11,4001,4503,502,05-10-2021
1000013869,12,4121,4503,382,05-11-2021
1000013869,13,4245,4503,258,05-12-2021
1000013869,14,4371,4502,131,05-01-2022
1000013870,1,0,734,734,05-01-2021
1000013870,2,1452,2196,744,05-02-2021
1000013870,3,1495,2196,701,05-03-2021
1000013870,4,1540,2196,656,05-04-2021
1000013870,5,1586,2196,610,05-05-2021
1000013870,6,1634,2196,562,05-06-2021
1000013870,7,1683,2196,513,05-07-2021
1000013870,8,1734,2196,462,05-08-2021
1000013870,9,1786,2196,410,05-09-2021
1000013870,10,1839,2196,357,05-10-2021
1000013870,11,1894,2196,302,05-11-2021
1000013870,12,1951,2196,245,05-12-2021
1000013870,13,2010,2196,186,05-01-2022
1000013870,14,2070,2196,126,05-02-2022
1000013870,15,2130,2193,63,05-03-2022
1000013871,1,0,516,516,05-01-2021
1000013871,2,0,516,516,05-02-2021
1000013871,3,0,516,516,05-03-2021
1000013871,4,0,516,516,05-04-2021
1000013871,5,0,516,516,05-05-2021
1000013871,6,0,516,516,05-06-2021
1000013871,7,4111,4627,516,05-07-2021
1000013871,8,4234,4627,393,05-08-2021
1000013871,9,4361,4627,266,05-09-2021
1000013871,10,4492,4627,135,05-10-2021
1000013872,1,0,381,381,05-01-2021
1000013872,2,0,381,381,05-02-2021
1000013872,3,0,381,381,05-03-2021
1000013872,4,0,381,381,05-04-2021
1000013872,5,0,381,381,05-05-2021
1000013872,6,0,381,381,05-06-2021
1000013872,7,1963,2344,381,05-07-2021
1000013872,8,2022,2344,322,05-08-2021
1000013872,9,2083,2344,261,05-09-2021
1000013872,10,2145,2344,199,05-10-2021
1000013872,11,2209,2344,135,05-11-2021
1000013872,12,2276,2344,68,05-12-2021
1000013872,13,2,2,0,05-01-2022
1000013873,1,0,198,198,05-01-2021
1000013873,2,0,198,198,05-02-2021
1000013873,3,0,198,198,05-03-2021
1000013873,4,0,198,198,05-04-2021
1000013873,5,0,198,198,05-05-2021
1000013873,6,0,198,198,05-06-2021
1000013873,7,6594,6792,198,05-07-2021
1000013874,1,0,367,367,05-01-2021
1000013874,2,874,1246,372,05-02-2021
1000013874,3,900,1246,346,05-03-2021
1000013874,4,927,1246,319,05-04-2021
1000013874,5,955,1246,291,05-05-2021
1000013874,6,984,1246,262,05-06-2021
1000013874,7,1013,1246,233,05-07-2021
1000013874,8,1044,1246,202,05-08-2021
1000013874,9,1075,1246,171,05-09-2021
1000013874,10,1107,1246,139,05-10-2021
1000013874,11,1140,1246,106,05-11-2021
1000013874,12,1175,1246,71,05-12-2021
1000013874,13,1206,1242,36,05-01-2022
1000013875,1,0,128,128,05-01-2021
1000013875,2,0,128,128,05-02-2021
1000013875,3,0,128,128,05-03-2021
1000013875,4,0,128,128,05-04-2021
1000013875,5,0,128,128,05-05-2021
1000013875,6,0,128,128,05-06-2021
1000013875,7,2106,2234,128,05-07-2021
1000013875,8,2169,2234,65,05-08-2021
1000013876,1,0,372,372,05-01-2021
1000013876,2,0,372,372,05-02-2021
1000013876,3,0,372,372,05-03-2021
1000013876,4,0,372,372,05-04-2021
1000013876,5,0,372,372,05-05-2021
1000013876,6,0,372,372,05-06-2021
1000013876,7,1917,2289,372,05-07-2021
1000013876,8,1975,2289,314,05-08-2021
1000013876,9,2034,2289,255,05-09-2021
1000013876,10,2095,2289,194,05-10-2021
1000013876,11,2158,2289,131,05-11-2021
1000013876,12,2222,2289,67,05-12-2021
1000013877,1,0,191,191,05-01-2021
1000013877,2,0,191,191,05-02-2021
1000013877,3,0,191,191,05-03-2021
1000013877,4,0,191,191,05-04-2021
1000013877,5,0,191,191,05-05-2021
1000013877,6,0,191,191,05-06-2021
1000013877,7,3143,3334,191,05-07-2021
1000013877,8,3237,3334,97,05-08-2021
1000013878,1,0,1005,1005,05-01-2021
1000013878,2,1686,2705,1019,05-02-2021
1000013878,3,1736,2705,969,05-03-2021
1000013878,4,1788,2705,917,05-04-2021
1000013878,5,1842,2705,863,05-05-2021
1000013878,6,1897,2705,808,05-06-2021
1000013878,7,1954,2705,751,05-07-2021
1000013878,8,2013,2705,692,05-08-2021
1000013878,9,2073,2705,632,05-09-2021
1000013878,10,2135,2705,570,05-10-2021
1000013878,11,2199,2705,506,05-11-2021
1000013878,12,2265,2705,440,05-12-2021
1000013878,13,2333,2705,372,05-01-2022
1000013878,14,2403,2705,302,05-02-2022
1000013878,15,2475,2705,230,05-03-2022
1000013878,16,2550,2705,155,05-04-2022
1000013878,17,2631,2708,77,05-05-2022
1000013879,1,0,263,263,05-01-2021
1000013879,2,0,263,263,05-02-2021
1000013879,3,0,263,263,05-03-2021
1000013879,4,0,263,263,05-04-2021
1000013879,5,0,263,263,05-05-2021
1000013879,6,0,263,263,05-06-2021
1000013879,7,2091,2354,263,05-07-2021
1000013879,8,2154,2354,200,05-08-2021
1000013879,9,2219,2354,135,05-09-2021
1000013879,10,2286,2354,68,05-10-2021
1000013880,1,1721,2603,882,05-01-2021
1000013880,2,1772,2603,831,05-02-2021
1000013880,3,1826,2603,777,05-03-2021
1000013880,4,1880,2603,723,05-04-2021
1000013880,5,1937,2603,666,05-05-2021
1000013880,6,1995,2603,608,05-06-2021
1000013880,7,2055,2603,548,05-07-2021
1000013880,8,2116,2603,487,05-08-2021
1000013880,9,2180,2603,423,05-09-2021
1000013880,10,2245,2603,358,05-10-2021
1000013880,11,2313,2603,290,05-11-2021
1000013880,12,2382,2603,221,05-12-2021
1000013880,13,2453,2603,150,05-01-2022
1000013880,14,2534,2610,76,05-02-2022
1000013881,1,1002,1196,194,05-01-2021
1000013881,2,1032,1196,164,05-02-2021
1000013881,3,1063,1196,133,05-03-2021
1000013881,4,1095,1196,101,05-04-2021
1000013881,5,1127,1196,69,05-05-2021
1000013881,6,1159,1194,35,05-06-2021
1000013882,1,914,1229,315,05-01-2021
1000013882,2,942,1229,287,05-02-2021
1000013882,3,970,1229,259,05-03-2021
1000013882,4,999,1229,230,05-04-2021
1000013882,5,1029,1229,200,05-05-2021
1000013882,6,1060,1229,169,05-06-2021
1000013882,7,1092,1229,137,05-07-2021
1000013882,8,1125,1229,104,05-08-2021
1000013882,9,1158,1229,71,05-09-2021
1000013882,10,1197,1232,35,05-10-2021
1000013883,1,1376,1743,367,05-01-2021
1000013883,2,1417,1743,326,05-02-2021
1000013883,3,1460,1743,283,05-03-2021
1000013883,4,1504,1743,239,05-04-2021
1000013883,5,1549,1743,194,05-05-2021
1000013883,6,1595,1743,148,05-06-2021
1000013883,7,1643,1743,100,05-07-2021
1000013883,8,1688,1739,51,05-08-2021
1000013884,1,0,966,966,05-01-2021
1000013884,2,0,966,966,05-02-2021
1000013884,3,0,966,966,05-03-2021
1000013884,4,0,966,966,05-04-2021
1000013884,5,0,966,966,05-05-2021
1000013884,6,0,966,966,05-06-2021
1000013884,7,6067,7033,966,05-07-2021
1000013884,8,6249,7033,784,05-08-2021
1000013884,9,6436,7033,597,05-09-2021
1000013884,10,6629,7033,404,05-10-2021
1000013884,11,6830,7035,205,05-11-2021
1000013885,1,1784,2699,915,05-01-2021
1000013885,2,1838,2699,861,05-02-2021
1000013885,3,1893,2699,806,05-03-2021
1000013885,4,1950,2699,749,05-04-2021
1000013885,5,2008,2699,691,05-05-2021
1000013885,6,2069,2699,630,05-06-2021
1000013885,7,2131,2699,568,05-07-2021
1000013885,8,2195,2699,504,05-08-2021
1000013885,9,2260,2699,439,05-09-2021
1000013885,10,2328,2699,371,05-10-2021
1000013885,11,2398,2699,301,05-11-2021
1000013885,12,2470,2699,229,05-12-2021
1000013885,13,2544,2699,155,05-01-2022
1000013885,14,2617,2695,78,05-02-2022
1000013886,1,1628,2612,984,05-01-2021
1000013886,2,1676,2612,936,05-02-2021
1000013886,3,1727,2612,885,05-03-2021
1000013886,4,1779,2612,833,05-04-2021
1000013886,5,1832,2612,780,05-05-2021
1000013886,6,1887,2612,725,05-06-2021
1000013886,7,1943,2612,669,05-07-2021
1000013886,8,2002,2612,610,05-08-2021
1000013886,9,2062,2612,550,05-09-2021
1000013886,10,2124,2612,488,05-10-2021
1000013886,11,2187,2612,425,05-11-2021
1000013886,12,2253,2612,359,05-12-2021
1000013886,13,2321,2612,291,05-01-2022
1000013886,14,2390,2612,222,05-02-2022
1000013886,15,2462,2612,150,05-03-2022
1000013886,16,2540,2616,76,05-04-2022
1000013887,1,923,1240,317,05-01-2021
1000013887,2,950,1240,290,05-02-2021
1000013887,3,979,1240,261,05-03-2021
1000013887,4,1008,1240,232,05-04-2021
1000013887,5,1038,1240,202,05-05-2021
1000013887,6,1070,1240,170,05-06-2021
1000013887,7,1102,1240,138,05-07-2021
1000013887,8,1135,1240,105,05-08-2021
1000013887,9,1169,1240,71,05-09-2021
1000013887,10,1204,1240,36,05-10-2021
1000013888,1,2151,2421,270,05-01-2021
1000013888,2,2216,2421,205,05-02-2021
1000013888,3,2282,2421,139,05-03-2021
1000013888,4,2349,2419,70,05-04-2021
1000013889,1,0,749,749,05-01-2021
1000013889,2,0,749,749,05-02-2021
1000013889,3,0,749,749,05-03-2021
1000013889,4,0,749,749,05-04-2021
1000013889,5,0,749,749,05-05-2021
1000013889,6,0,749,749,05-06-2021
1000013889,7,3256,4005,749,05-07-2021
1000013889,8,3354,4005,651,05-08-2021
1000013889,9,3455,4005,550,05-09-2021
1000013889,10,3558,4005,447,05-10-2021
1000013889,11,3665,4005,340,05-11-2021
1000013889,12,3775,4005,230,05-12-2021
1000013889,13,3891,4007,116,05-01-2022
1000013890,1,0,308,308,05-01-2021
1000013890,2,0,308,308,05-02-2021
1000013890,3,0,308,308,05-03-2021
1000013890,4,0,308,308,05-04-2021
1000013890,5,0,308,308,05-05-2021
1000013890,6,0,308,308,05-06-2021
1000013890,7,1931,2239,308,05-07-2021
1000013890,8,1989,2239,250,05-08-2021
1000013890,9,2049,2239,190,05-09-2021
1000013890,10,2110,2239,129,05-10-2021
1000013890,11,2176,2240,64,05-11-2021
1000013891,1,0,261,261,05-01-2021
1000013891,2,0,261,261,05-02-2021
1000013891,3,0,261,261,05-03-2021
1000013891,4,0,261,261,05-04-2021
1000013891,5,0,261,261,05-05-2021
1000013891,6,0,261,261,05-06-2021
1000013891,7,2084,2345,261,05-07-2021
1000013891,8,2146,2345,199,05-08-2021
1000013891,9,2210,2345,135,05-09-2021
1000013891,10,2276,2344,68,05-10-2021
1000013892,1,977,1167,190,05-01-2021
1000013892,2,1007,1167,160,05-02-2021
1000013892,3,1037,1167,130,05-03-2021
1000013892,4,1068,1167,99,05-04-2021
1000013892,5,1100,1167,67,05-05-2021
1000013892,6,1132,1166,34,05-06-2021
1000013893,1,0,390,390,05-01-2021
1000013893,2,0,390,390,05-02-2021
1000013893,3,0,390,390,05-03-2021
1000013893,4,0,390,390,05-04-2021
1000013893,5,0,390,390,05-05-2021
1000013893,6,0,390,390,05-06-2021
1000013893,7,2010,2400,390,05-07-2021
1000013893,8,2070,2400,330,05-08-2021
1000013893,9,2132,2400,268,05-09-2021
1000013893,10,2196,2400,204,05-10-2021
1000013893,11,2262,2400,138,05-11-2021
1000013893,12,2330,2399,69,05-12-2021
1000013894,1,0,381,381,05-01-2021
1000013894,2,0,381,381,05-02-2021
1000013894,3,0,381,381,05-03-2021
1000013894,4,0,381,381,05-04-2021
1000013894,5,0,381,381,05-05-2021
1000013894,6,0,381,381,05-06-2021
1000013894,7,6256,6637,381,05-07-2021
1000013894,8,6444,6637,193,05-08-2021
1000013895,1,895,1276,381,05-01-2021
1000013895,2,922,1276,354,05-02-2021
1000013895,3,950,1276,326,05-03-2021
1000013895,4,978,1276,298,05-04-2021
1000013895,5,1007,1276,269,05-05-2021
1000013895,6,1038,1276,238,05-06-2021
1000013895,7,1069,1276,207,05-07-2021
1000013895,8,1101,1276,175,05-08-2021
1000013895,9,1134,1276,142,05-09-2021
1000013895,10,1168,1276,108,05-10-2021
1000013895,11,1203,1276,73,05-11-2021
1000013895,12,1235,1272,37,05-12-2021
1000013896,1,0,393,393,05-01-2021
1000013896,2,0,393,393,05-02-2021
1000013896,3,0,393,393,05-03-2021
1000013896,4,0,393,393,05-04-2021
1000013896,5,0,393,393,05-05-2021
1000013896,6,0,393,393,05-06-2021
1000013896,7,4239,4632,393,05-07-2021
1000013896,8,4366,4632,266,05-08-2021
1000013896,9,4498,4633,135,05-09-2021
1000013897,1,2102,2366,264,05-01-2021
1000013897,2,2165,2366,201,05-02-2021
1000013897,3,2230,2366,136,05-03-2021
1000013897,4,2298,2366,68,05-04-2021
1000013898,1,0,381,381,05-01-2021
1000013898,2,0,381,381,05-02-2021
1000013898,3,0,381,381,05-03-2021
1000013898,4,0,381,381,05-04-2021
1000013898,5,0,381,381,05-05-2021
1000013898,6,0,381,381,05-06-2021
1000013898,7,1963,2344,381,05-07-2021
1000013898,8,2022,2344,322,05-08-2021
1000013898,9,2083,2344,261,05-09-2021
1000013898,10,2145,2344,199,05-10-2021
1000013898,11,2209,2344,135,05-11-2021
1000013898,12,2278,2346,68,05-12-2021
1000013899,1,976,1165,189,05-01-2021
1000013899,2,1005,1165,160,05-02-2021
1000013899,3,1035,1165,130,05-03-2021
1000013899,4,1066,1165,99,05-04-2021
1000013899,5,1098,1165,67,05-05-2021
1000013899,6,1131,1165,34,05-06-2021
1000013900,1,0,898,898,05-01-2021
1000013900,2,0,898,898,05-02-2021
1000013900,3,0,898,898,05-03-2021
1000013900,4,0,898,898,05-04-2021
1000013900,5,0,898,898,05-05-2021
1000013900,6,0,898,898,05-06-2021
1000013900,7,3909,4807,898,05-07-2021
1000013900,8,4026,4807,781,05-08-2021
1000013900,9,4147,4807,660,05-09-2021
1000013900,10,4271,4807,536,05-10-2021
1000013900,11,4399,4807,408,05-11-2021
1000013900,12,4531,4807,276,05-12-2021
1000013900,13,4664,4804,140,05-01-2022
1000013901,1,1490,2125,635,05-01-2021
1000013901,2,1535,2125,590,05-02-2021
1000013901,3,1581,2125,544,05-03-2021
1000013901,4,1629,2125,496,05-04-2021
1000013901,5,1677,2125,448,05-05-2021
1000013901,6,1728,2125,397,05-06-2021
1000013901,7,1780,2125,345,05-07-2021
1000013901,8,1833,2125,292,05-08-2021
1000013901,9,1888,2125,237,05-09-2021
1000013901,10,1945,2125,180,05-10-2021
1000013901,11,2003,2125,122,05-11-2021
1000013901,12,2065,2127,62,05-12-2021
1000013902,1,0,747,747,05-01-2021
1000013902,2,0,747,747,05-02-2021
1000013902,3,0,747,747,05-03-2021
1000013902,4,0,747,747,05-04-2021
1000013902,5,0,747,747,05-05-2021
1000013902,6,0,747,747,05-06-2021
1000013902,7,3851,4598,747,05-07-2021
1000013902,8,3966,4598,632,05-08-2021
1000013902,9,4085,4598,513,05-09-2021
1000013902,10,4208,4598,390,05-10-2021
1000013902,11,4334,4598,264,05-11-2021
1000013902,12,4466,4600,134,05-12-2021
1000013903,1,0,1006,1006,05-01-2021
1000013903,2,0,1006,1006,05-02-2021
1000013903,3,0,1006,1006,05-03-2021
1000013903,4,0,1006,1006,05-04-2021
1000013903,5,0,1006,1006,05-05-2021
1000013903,6,0,1006,1006,05-06-2021
1000013903,7,3771,4777,1006,05-07-2021
1000013903,8,3884,4777,893,05-08-2021
1000013903,9,4001,4777,776,05-09-2021
1000013903,10,4121,4777,656,05-10-2021
1000013903,11,4244,4777,533,05-11-2021
1000013903,12,4372,4777,405,05-12-2021
1000013903,13,4503,4777,274,05-01-2022
1000013903,14,4639,4778,139,05-02-2022
1000013904,1,1137,1720,583,05-01-2021
1000013904,2,1171,1720,549,05-02-2021
1000013904,3,1207,1720,513,05-03-2021
1000013904,4,1243,1720,477,05-04-2021
1000013904,5,1280,1720,440,05-05-2021
1000013904,6,1318,1720,402,05-06-2021
1000013904,7,1358,1720,362,05-07-2021
1000013904,8,1399,1720,321,05-08-2021
1000013904,9,1441,1720,279,05-09-2021
1000013904,10,1484,1720,236,05-10-2021
1000013904,11,1528,1720,192,05-11-2021
1000013904,12,1574,1720,146,05-12-2021
1000013904,13,1621,1720,99,05-01-2022
1000013904,14,1663,1713,50,05-02-2022
1000013905,1,1756,2224,468,05-01-2021
1000013905,2,1808,2224,416,05-02-2021
1000013905,3,1863,2224,361,05-03-2021
1000013905,4,1918,2224,306,05-04-2021
1000013905,5,1976,2224,248,05-05-2021
1000013905,6,2035,2224,189,05-06-2021
1000013905,7,2096,2224,128,05-07-2021
1000013905,8,2159,2223,64,05-08-2021
1000013906,1,0,315,315,05-01-2021
1000013906,2,0,315,315,05-02-2021
1000013906,3,0,315,315,05-03-2021
1000013906,4,0,315,315,05-04-2021
1000013906,5,0,315,315,05-05-2021
1000013906,6,0,315,315,05-06-2021
1000013906,7,1975,2290,315,05-07-2021
1000013906,8,2035,2290,255,05-08-2021
1000013906,9,2096,2290,194,05-09-2021
1000013906,10,2159,2290,131,05-10-2021
1000013906,11,2221,2288,67,05-11-2021
1000013907,1,932,1181,249,05-01-2021
1000013907,2,960,1181,221,05-02-2021
1000013907,3,989,1181,192,05-03-2021
1000013907,4,1019,1181,162,05-04-2021
1000013907,5,1049,1181,132,05-05-2021
1000013907,6,1081,1181,100,05-06-2021
1000013907,7,1113,1181,68,05-07-2021
1000013907,8,1145,1178,33,05-08-2021
1000013908,1,955,1210,255,05-01-2021
1000013908,2,984,1210,226,05-02-2021
1000013908,3,1013,1210,197,05-03-2021
1000013908,4,1044,1210,166,05-04-2021
1000013908,5,1075,1210,135,05-05-2021
1000013908,6,1107,1210,103,05-06-2021
1000013908,7,1140,1210,70,05-07-2021
1000013908,8,1178,1212,34,05-08-2021
1000013909,1,2151,2421,270,05-01-2021
1000013909,2,2216,2421,205,05-02-2021
1000013909,3,2282,2421,139,05-03-2021
1000013909,4,2349,2419,70,05-04-2021
1000013910,1,2151,2421,270,05-01-2021
1000013910,2,2216,2421,205,05-02-2021
1000013910,3,2282,2421,139,05-03-2021
1000013910,4,2349,2419,70,05-04-2021
1000013911,1,0,321,321,05-01-2021
1000013911,2,0,321,321,05-02-2021
1000013911,3,0,321,321,05-03-2021
1000013911,4,0,321,321,05-04-2021
1000013911,5,0,321,321,05-05-2021
1000013911,6,0,321,321,05-06-2021
1000013911,7,2019,2340,321,05-07-2021
1000013911,8,2079,2340,261,05-08-2021
1000013911,9,2141,2340,199,05-09-2021
1000013911,10,2206,2340,134,05-10-2021
1000013911,11,2271,2339,68,05-11-2021
1000013912,1,0,321,321,05-01-2021
1000013912,2,0,321,321,05-02-2021
1000013912,3,0,321,321,05-03-2021
1000013912,4,0,321,321,05-04-2021
1000013912,5,0,321,321,05-05-2021
1000013912,6,0,321,321,05-06-2021
1000013912,7,2019,2340,321,05-07-2021
1000013912,8,2079,2340,261,05-08-2021
1000013912,9,2141,2340,199,05-09-2021
1000013912,10,2206,2340,134,05-10-2021
1000013912,11,2271,2339,68,05-11-2021
1000013913,1,2005,2257,252,05-01-2021
1000013913,2,2065,2257,192,05-02-2021
1000013913,3,2127,2257,130,05-03-2021
1000013913,4,2192,2256,64,05-04-2021
1000013914,1,2461,2939,478,05-01-2021
1000013914,2,2535,2939,404,05-02-2021
1000013914,3,2611,2939,328,05-03-2021
1000013914,4,2690,2939,249,05-04-2021
1000013914,5,2770,2939,169,05-05-2021
1000013914,6,2854,2939,85,05-06-2021
1000013915,1,1002,1196,194,05-01-2021
1000013915,2,1032,1196,164,05-02-2021
1000013915,3,1063,1196,133,05-03-2021
1000013915,4,1095,1196,101,05-04-2021
1000013915,5,1127,1196,69,05-05-2021
1000013915,6,1159,1194,35,05-06-2021
1000013916,1,992,1117,125,05-01-2021
1000013916,2,1022,1117,95,05-02-2021
1000013916,3,1053,1117,64,05-03-2021
1000013916,4,1084,1116,32,05-04-2021
1000013917,1,0,381,381,05-01-2021
1000013917,2,0,381,381,05-02-2021
1000013917,3,0,381,381,05-03-2021
1000013917,4,0,381,381,05-04-2021
1000013917,5,0,381,381,05-05-2021
1000013917,6,0,381,381,05-06-2021
1000013917,7,6256,6637,381,05-07-2021
1000013917,8,6444,6637,193,05-08-2021
1000013918,1,0,381,381,05-01-2021
1000013918,2,0,381,381,05-02-2021
1000013918,3,0,381,381,05-03-2021
1000013918,4,0,381,381,05-04-2021
1000013918,5,0,381,381,05-05-2021
1000013918,6,0,381,381,05-06-2021
1000013918,7,1963,2344,381,05-07-2021
1000013918,8,2022,2344,322,05-08-2021
1000013918,9,2083,2344,261,05-09-2021
1000013918,10,2145,2344,199,05-10-2021
1000013918,11,2209,2344,135,05-11-2021
1000013918,12,2278,2346,68,05-12-2021
1000013919,1,0,656,656,05-01-2021
1000013919,2,0,656,656,05-02-2021
1000013919,3,0,656,656,05-03-2021
1000013919,4,0,656,656,05-04-2021
1000013919,5,0,656,656,05-05-2021
1000013919,6,0,656,656,05-06-2021
1000013919,7,2461,3117,656,05-07-2021
1000013919,8,2535,3117,582,05-08-2021
1000013919,9,2611,3117,506,05-09-2021
1000013919,10,2689,3117,428,05-10-2021
1000013919,11,2770,3117,347,05-11-2021
1000013919,12,2853,3117,264,05-12-2021
1000013919,13,2938,3117,179,05-01-2022
1000013919,14,3020,3111,91,05-02-2022
1000013920,1,1428,1809,381,05-01-2021
1000013920,2,1471,1809,338,05-02-2021
1000013920,3,1515,1809,294,05-03-2021
1000013920,4,1560,1809,249,05-04-2021
1000013920,5,1607,1809,202,05-05-2021
1000013920,6,1655,1809,154,05-06-2021
1000013920,7,1705,1809,104,05-07-2021
1000013920,8,1759,1811,52,05-08-2021
1000013921,1,0,685,685,05-01-2021
1000013921,2,0,685,685,05-02-2021
1000013921,3,0,685,685,05-03-2021
1000013921,4,0,685,685,05-04-2021
1000013921,5,0,685,685,05-05-2021
1000013921,6,0,685,685,05-06-2021
1000013921,7,5454,6139,685,05-07-2021
1000013921,8,5618,6139,521,05-08-2021
1000013921,9,5787,6139,352,05-09-2021
1000013921,10,5962,6141,179,05-10-2021
1000013922,1,0,381,381,05-01-2021
1000013922,2,0,381,381,05-02-2021
1000013922,3,0,381,381,05-03-2021
1000013922,4,0,381,381,05-04-2021
1000013922,5,0,381,381,05-05-2021
1000013922,6,0,381,381,05-06-2021
1000013922,7,4109,4490,381,05-07-2021
1000013922,8,4232,4490,258,05-08-2021
1000013922,9,4359,4490,131,05-09-2021
1000013923,1,0,264,264,05-01-2021
1000013923,2,0,264,264,05-02-2021
1000013923,3,0,264,264,05-03-2021
1000013923,4,0,264,264,05-04-2021
1000013923,5,0,264,264,05-05-2021
1000013923,6,0,264,264,05-06-2021
1000013923,7,4332,4596,264,05-07-2021
1000013923,8,4463,4597,134,05-08-2021
1000013924,1,1590,2137,547,05-01-2021
1000013924,2,1638,2137,499,05-02-2021
1000013924,3,1687,2137,450,05-03-2021
1000013924,4,1737,2137,400,05-04-2021
1000013924,5,1790,2137,347,05-05-2021
1000013924,6,1843,2137,294,05-06-2021
1000013924,7,1899,2137,238,05-07-2021
1000013924,8,1956,2137,181,05-08-2021
1000013924,9,2014,2137,123,05-09-2021
1000013924,10,2078,2140,62,05-10-2021
1000013925,1,895,1276,381,05-01-2021
1000013925,2,922,1276,354,05-02-2021
1000013925,3,950,1276,326,05-03-2021
1000013925,4,978,1276,298,05-04-2021
1000013925,5,1007,1276,269,05-05-2021
1000013925,6,1038,1276,238,05-06-2021
1000013925,7,1069,1276,207,05-07-2021
1000013925,8,1101,1276,175,05-08-2021
1000013925,9,1134,1276,142,05-09-2021
1000013925,10,1168,1276,108,05-10-2021
1000013925,11,1203,1276,73,05-11-2021
1000013925,12,1235,1272,37,05-12-2021
1000013926,1,1376,1743,367,05-01-2021
1000013926,2,1417,1743,326,05-02-2021
1000013926,3,1460,1743,283,05-03-2021
1000013926,4,1504,1743,239,05-04-2021
1000013926,5,1549,1743,194,05-05-2021
1000013926,6,1595,1743,148,05-06-2021
1000013926,7,1643,1743,100,05-07-2021
1000013926,8,1688,1739,51,05-08-2021
1000013927,1,1664,2670,1006,05-01-2021
1000013927,2,1714,2670,956,05-02-2021
1000013927,3,1765,2670,905,05-03-2021
1000013927,4,1818,2670,852,05-04-2021
1000013927,5,1873,2670,797,05-05-2021
1000013927,6,1929,2670,741,05-06-2021
1000013927,7,1987,2670,683,05-07-2021
1000013927,8,2046,2670,624,05-08-2021
1000013927,9,2108,2670,562,05-09-2021
1000013927,10,2171,2670,499,05-10-2021
1000013927,11,2236,2670,434,05-11-2021
1000013927,12,2303,2670,367,05-12-2021
1000013927,13,2372,2670,298,05-01-2022
1000013927,14,2444,2670,226,05-02-2022
1000013927,15,2517,2670,153,05-03-2022
1000013927,16,2588,2666,78,05-04-2022
1000013928,1,895,1276,381,05-01-2021
1000013928,2,922,1276,354,05-02-2021
1000013928,3,950,1276,326,05-03-2021
1000013928,4,978,1276,298,05-04-2021
1000013928,5,1007,1276,269,05-05-2021
1000013928,6,1038,1276,238,05-06-2021
1000013928,7,1069,1276,207,05-07-2021
1000013928,8,1101,1276,175,05-08-2021
1000013928,9,1134,1276,142,05-09-2021
1000013928,10,1168,1276,108,05-10-2021
1000013928,11,1203,1276,73,05-11-2021
1000013928,12,1235,1272,37,05-12-2021
1000013929,1,0,134,134,05-01-2021
1000013929,2,0,134,134,05-02-2021
1000013929,3,0,134,134,05-03-2021
1000013929,4,0,134,134,05-04-2021
1000013929,5,0,134,134,05-05-2021
1000013929,6,0,134,134,05-06-2021
1000013929,7,4463,4597,134,05-07-2021
1000013930,1,0,321,321,05-01-2021
1000013930,2,0,321,321,05-02-2021
1000013930,3,0,321,321,05-03-2021
1000013930,4,0,321,321,05-04-2021
1000013930,5,0,321,321,05-05-2021
1000013930,6,0,321,321,05-06-2021
1000013930,7,2019,2340,321,05-07-2021
1000013930,8,2079,2340,261,05-08-2021
1000013930,9,2141,2340,199,05-09-2021
1000013930,10,2206,2340,134,05-10-2021
1000013930,11,2271,2339,68,05-11-2021
1000013931,1,1186,1502,316,05-01-2021
1000013931,2,1221,1502,281,05-02-2021
1000013931,3,1258,1502,244,05-03-2021
1000013931,4,1296,1502,206,05-04-2021
1000013931,5,1334,1502,168,05-05-2021
1000013931,6,1374,1502,128,05-06-2021
1000013931,7,1416,1502,86,05-07-2021
1000013931,8,1461,1505,44,05-08-2021
1000013932,1,0,303,303,05-01-2021
1000013932,2,0,303,303,05-02-2021
1000013932,3,0,303,303,05-03-2021
1000013932,4,0,303,303,05-04-2021
1000013932,5,0,303,303,05-05-2021
1000013932,6,0,303,303,05-06-2021
1000013932,7,3266,3569,303,05-07-2021
1000013932,8,3364,3569,205,05-08-2021
1000013932,9,3464,3568,104,05-09-2021
1000013933,1,2443,2592,149,05-01-2021
1000013933,2,2517,2592,75,05-02-2021
1000013934,1,0,304,304,05-01-2021
1000013934,2,897,1205,308,05-02-2021
1000013934,3,924,1205,281,05-03-2021
1000013934,4,951,1205,254,05-04-2021
1000013934,5,980,1205,225,05-05-2021
1000013934,6,1009,1205,196,05-06-2021
1000013934,7,1039,1205,166,05-07-2021
1000013934,8,1071,1205,134,05-08-2021
1000013934,9,1103,1205,102,05-09-2021
1000013934,10,1136,1205,69,05-10-2021
1000013934,11,1168,1203,35,05-11-2021
1000013935,1,0,769,769,05-01-2021
1000013935,2,0,769,769,05-02-2021
1000013935,3,0,769,769,05-03-2021
1000013935,4,0,769,769,05-04-2021
1000013935,5,0,769,769,05-05-2021
1000013935,6,0,769,769,05-06-2021
1000013935,7,3962,4731,769,05-07-2021
1000013935,8,4081,4731,650,05-08-2021
1000013935,9,4203,4731,528,05-09-2021
1000013935,10,4329,4731,402,05-10-2021
1000013935,11,4459,4731,272,05-11-2021
1000013935,12,4593,4731,138,05-12-2021
1000013935,13,1,1,0,05-01-2022
1000013936,1,0,1101,1101,05-01-2021
1000013936,2,1081,2197,1116,05-02-2021
1000013936,3,1113,2197,1084,05-03-2021
1000013936,4,1147,2197,1050,05-04-2021
1000013936,5,1181,2197,1016,05-05-2021
1000013936,6,1217,2197,980,05-06-2021
1000013936,7,1253,2197,944,05-07-2021
1000013936,8,1291,2197,906,05-08-2021
1000013936,9,1329,2197,868,05-09-2021
1000013936,10,1369,2197,828,05-10-2021
1000013936,11,1410,2197,787,05-11-2021
1000013936,12,1453,2197,744,05-12-2021
1000013936,13,1496,2197,701,05-01-2022
1000013936,14,1541,2197,656,05-02-2022
1000013936,15,1587,2197,610,05-03-2022
1000013936,16,1635,2197,562,05-04-2022
1000013936,17,1684,2197,513,05-05-2022
1000013936,18,1735,2197,462,05-06-2022
1000013936,19,1787,2197,410,05-07-2022
1000013936,20,1840,2197,357,05-08-2022
1000013936,21,1895,2197,302,05-09-2022
1000013936,22,1952,2197,245,05-10-2022
1000013936,23,2011,2197,186,05-11-2022
1000013936,24,2071,2197,126,05-12-2022
1000013936,25,2122,2186,64,05-01-2023
1000013937,1,0,193,193,05-01-2021
1000013937,2,0,193,193,05-02-2021
1000013937,3,0,193,193,05-03-2021
1000013937,4,0,193,193,05-04-2021
1000013937,5,0,193,193,05-05-2021
1000013937,6,0,193,193,05-06-2021
1000013937,7,6442,6635,193,05-07-2021
1000013938,1,914,1229,315,05-01-2021
1000013938,2,942,1229,287,05-02-2021
1000013938,3,970,1229,259,05-03-2021
1000013938,4,999,1229,230,05-04-2021
1000013938,5,1029,1229,200,05-05-2021
1000013938,6,1060,1229,169,05-06-2021
1000013938,7,1092,1229,137,05-07-2021
1000013938,8,1125,1229,104,05-08-2021
1000013938,9,1158,1229,71,05-09-2021
1000013938,10,1197,1232,35,05-10-2021
1000013939,1,0,263,263,05-01-2021
1000013939,2,0,263,263,05-02-2021
1000013939,3,0,263,263,05-03-2021
1000013939,4,0,263,263,05-04-2021
1000013939,5,0,263,263,05-05-2021
1000013939,6,0,263,263,05-06-2021
1000013939,7,2097,2360,263,05-07-2021
1000013939,8,2160,2360,200,05-08-2021
1000013939,9,2224,2360,136,05-09-2021
1000013939,10,2293,2362,69,05-10-2021
1000013940,1,0,322,322,05-01-2021
1000013940,2,0,322,322,05-02-2021
1000013940,3,0,322,322,05-03-2021
1000013940,4,0,322,322,05-04-2021
1000013940,5,0,322,322,05-05-2021
1000013940,6,0,322,322,05-06-2021
1000013940,7,2023,2345,322,05-07-2021
1000013940,8,2083,2345,262,05-08-2021
1000013940,9,2146,2345,199,05-09-2021
1000013940,10,2210,2345,135,05-10-2021
1000013940,11,2278,2346,68,05-11-2021
1000013941,1,0,199,199,05-01-2021
1000013941,2,0,199,199,05-02-2021
1000013941,3,0,199,199,05-03-2021
1000013941,4,0,199,199,05-04-2021
1000013941,5,0,199,199,05-05-2021
1000013941,6,0,199,199,05-06-2021
1000013941,7,2147,2346,199,05-07-2021
1000013941,8,2211,2346,135,05-08-2021
1000013941,9,2277,2345,68,05-09-2021
1000013942,1,0,189,189,05-01-2021
1000013942,2,0,189,189,05-02-2021
1000013942,3,0,189,189,05-03-2021
1000013942,4,0,189,189,05-04-2021
1000013942,5,0,189,189,05-05-2021
1000013942,6,0,189,189,05-06-2021
1000013942,7,2042,2231,189,05-07-2021
1000013942,8,2103,2231,128,05-08-2021
1000013942,9,2166,2231,65,05-09-2021
1000013943,1,0,381,381,05-01-2021
1000013943,2,0,381,381,05-02-2021
1000013943,3,0,381,381,05-03-2021
1000013943,4,0,381,381,05-04-2021
1000013943,5,0,381,381,05-05-2021
1000013943,6,0,381,381,05-06-2021
1000013943,7,6256,6637,381,05-07-2021
1000013943,8,6444,6637,193,05-08-2021
1000013944,1,0,64,64,05-01-2021
1000013944,2,1068,1133,65,05-02-2021
1000013944,3,1099,1132,33,05-03-2021
1000013945,1,0,194,194,05-01-2021
1000013945,2,0,194,194,05-02-2021
1000013945,3,0,194,194,05-03-2021
1000013945,4,0,194,194,05-04-2021
1000013945,5,0,194,194,05-05-2021
1000013945,6,0,194,194,05-06-2021
1000013945,7,2096,2290,194,05-07-2021
1000013945,8,2159,2290,131,05-08-2021
1000013945,9,2223,2290,67,05-09-2021
1000013946,1,0,152,152,05-01-2021
1000013946,2,0,152,152,05-02-2021
1000013946,3,0,152,152,05-03-2021
1000013946,4,0,152,152,05-04-2021
1000013946,5,0,152,152,05-05-2021
1000013946,6,0,152,152,05-06-2021
1000013946,7,2488,2640,152,05-07-2021
1000013946,8,2563,2639,76,05-08-2021
1000013947,1,0,610,610,05-01-2021
1000013947,2,0,610,610,05-02-2021
1000013947,3,0,610,610,05-03-2021
1000013947,4,0,610,610,05-04-2021
1000013947,5,0,610,610,05-05-2021
1000013947,6,0,610,610,05-06-2021
1000013947,7,2652,3262,610,05-07-2021
1000013947,8,2732,3262,530,05-08-2021
1000013947,9,2814,3262,448,05-09-2021
1000013947,10,2898,3262,364,05-10-2021
1000013947,11,2985,3262,277,05-11-2021
1000013947,12,3075,3262,187,05-12-2021
1000013947,13,3167,3262,95,05-01-2022
1000013948,1,0,394,394,05-01-2021
1000013948,2,1496,1895,399,05-02-2021
1000013948,3,1541,1895,354,05-03-2021
1000013948,4,1587,1895,308,05-04-2021
1000013948,5,1635,1895,260,05-05-2021
1000013948,6,1684,1895,211,05-06-2021
1000013948,7,1734,1895,161,05-07-2021
1000013948,8,1786,1895,109,05-08-2021
1000013948,9,1837,1892,55,05-09-2021
1000013949,1,1212,1447,235,05-01-2021
1000013949,2,1248,1447,199,05-02-2021
1000013949,3,1286,1447,161,05-03-2021
1000013949,4,1324,1447,123,05-04-2021
1000013949,5,1364,1447,83,05-05-2021
1000013949,6,1406,1448,42,05-06-2021
1000013950,1,0,458,458,05-01-2021
1000013950,2,0,458,458,05-02-2021
1000013950,3,0,458,458,05-03-2021
1000013950,4,0,458,458,05-04-2021
1000013950,5,0,458,458,05-05-2021
1000013950,6,0,458,458,05-06-2021
1000013950,7,3647,4105,458,05-07-2021
1000013950,8,3757,4105,348,05-08-2021
1000013950,9,3869,4105,236,05-09-2021
1000013950,10,3987,4106,119,05-10-2021
1000013951,1,0,372,372,05-01-2021
1000013951,2,0,372,372,05-02-2021
1000013951,3,0,372,372,05-03-2021
1000013951,4,0,372,372,05-04-2021
1000013951,5,0,372,372,05-05-2021
1000013951,6,0,372,372,05-06-2021
1000013951,7,4012,4384,372,05-07-2021
1000013951,8,4132,4384,252,05-08-2021
1000013951,9,4256,4383,127,05-09-2021
1000013952,1,1490,2124,634,05-01-2021
1000013952,2,1534,2124,590,05-02-2021
1000013952,3,1580,2124,544,05-03-2021
1000013952,4,1628,2124,496,05-04-2021
1000013952,5,1677,2124,447,05-05-2021
1000013952,6,1727,2124,397,05-06-2021
1000013952,7,1779,2124,345,05-07-2021
1000013952,8,1832,2124,292,05-08-2021
1000013952,9,1887,2124,237,05-09-2021
1000013952,10,1944,2124,180,05-10-2021
1000013952,11,2002,2124,122,05-11-2021
1000013952,12,2061,2122,61,05-12-2021
1000013953,1,2198,2332,134,05-01-2021
1000013953,2,2265,2333,68,05-02-2021
1000013954,1,0,367,367,05-01-2021
1000013954,2,0,367,367,05-02-2021
1000013954,3,0,367,367,05-03-2021
1000013954,4,0,367,367,05-04-2021
1000013954,5,0,367,367,05-05-2021
1000013954,6,0,367,367,05-06-2021
1000013954,7,2924,3291,367,05-07-2021
1000013954,8,3012,3291,279,05-08-2021
1000013954,9,3102,3291,189,05-09-2021
1000013954,10,3194,3290,96,05-10-2021
1000013955,1,0,261,261,05-01-2021
1000013955,2,0,261,261,05-02-2021
1000013955,3,0,261,261,05-03-2021
1000013955,4,0,261,261,05-04-2021
1000013955,5,0,261,261,05-05-2021
1000013955,6,0,261,261,05-06-2021
1000013955,7,2084,2345,261,05-07-2021
1000013955,8,2146,2345,199,05-08-2021
1000013955,9,2210,2345,135,05-09-2021
1000013955,10,2276,2344,68,05-10-2021
1000013956,1,953,1138,185,05-01-2021
1000013956,2,982,1138,156,05-02-2021
1000013956,3,1011,1138,127,05-03-2021
1000013956,4,1041,1138,97,05-04-2021
1000013956,5,1073,1138,65,05-05-2021
1000013956,6,1104,1137,33,05-06-2021
1000013957,1,2627,3137,510,05-01-2021
1000013957,2,2706,3137,431,05-02-2021
1000013957,3,2787,3137,350,05-03-2021
1000013957,4,2871,3137,266,05-04-2021
1000013957,5,2957,3137,180,05-05-2021
1000013957,6,3043,3134,91,05-06-2021
1000013959,1,1022,1150,128,05-01-2021
1000013959,2,1052,1150,98,05-02-2021
1000013959,3,1084,1150,66,05-03-2021
1000013959,4,1117,1150,33,05-04-2021
1000013960,1,0,516,516,05-01-2021
1000013960,2,0,516,516,05-02-2021
1000013960,3,0,516,516,05-03-2021
1000013960,4,0,516,516,05-04-2021
1000013960,5,0,516,516,05-05-2021
1000013960,6,0,516,516,05-06-2021
1000013960,7,4111,4627,516,05-07-2021
1000013960,8,4234,4627,393,05-08-2021
1000013960,9,4361,4627,266,05-09-2021
1000013960,10,4492,4627,135,05-10-2021
1000013961,1,0,128,128,05-01-2021
1000013961,2,0,128,128,05-02-2021
1000013961,3,0,128,128,05-03-2021
1000013961,4,0,128,128,05-04-2021
1000013961,5,0,128,128,05-05-2021
1000013961,6,0,128,128,05-06-2021
1000013961,7,4257,4385,128,05-07-2021
1000013962,1,1190,1339,149,05-01-2021
1000013962,2,1225,1339,114,05-02-2021
1000013962,3,1262,1339,77,05-03-2021
1000013962,4,1299,1338,39,05-04-2021
1000013963,1,1494,1784,290,05-01-2021
1000013963,2,1539,1784,245,05-02-2021
1000013963,3,1585,1784,199,05-03-2021
1000013963,4,1633,1784,151,05-04-2021
1000013963,5,1682,1784,102,05-05-2021
1000013963,6,1729,1781,52,05-06-2021
1000013964,1,2053,2311,258,05-01-2021
1000013964,2,2115,2311,196,05-02-2021
1000013964,3,2178,2311,133,05-03-2021
1000013964,4,2246,2313,67,05-04-2021
1000013965,1,2386,3206,820,05-01-2021
1000013965,2,2457,3206,749,05-02-2021
1000013965,3,2531,3206,675,05-03-2021
1000013965,4,2607,3206,599,05-04-2021
1000013965,5,2685,3206,521,05-05-2021
1000013965,6,2766,3206,440,05-06-2021
1000013965,7,2848,3206,358,05-07-2021
1000013965,8,2934,3206,272,05-08-2021
1000013965,9,3022,3206,184,05-09-2021
1000013965,10,3113,3206,93,05-10-2021
1000013966,1,957,1212,255,05-01-2021
1000013966,2,985,1212,227,05-02-2021
1000013966,3,1015,1212,197,05-03-2021
1000013966,4,1045,1212,167,05-04-2021
1000013966,5,1077,1212,135,05-05-2021
1000013966,6,1109,1212,103,05-06-2021
1000013966,7,1142,1212,70,05-07-2021
1000013966,8,1180,1214,34,05-08-2021
1000013967,1,1557,2092,535,05-01-2021
1000013967,2,1603,2092,489,05-02-2021
1000013967,3,1651,2092,441,05-03-2021
1000013967,4,1701,2092,391,05-04-2021
1000013967,5,1752,2092,340,05-05-2021
1000013967,6,1804,2092,288,05-06-2021
1000013967,7,1859,2092,233,05-07-2021
1000013967,8,1914,2092,178,05-08-2021
1000013967,9,1972,2092,120,05-09-2021
1000013967,10,2036,2097,61,05-10-2021
1000013968,1,0,101,101,05-01-2021
1000013968,2,0,101,101,05-02-2021
1000013968,3,0,101,101,05-03-2021
1000013968,4,0,101,101,05-04-2021
1000013968,5,0,101,101,05-05-2021
1000013968,6,0,101,101,05-06-2021
1000013968,7,1651,1752,101,05-07-2021
1000013968,8,1701,1752,51,05-08-2021
1000013969,1,0,261,261,05-01-2021
1000013969,2,0,261,261,05-02-2021
1000013969,3,0,261,261,05-03-2021
1000013969,4,0,261,261,05-04-2021
1000013969,5,0,261,261,05-05-2021
1000013969,6,0,261,261,05-06-2021
1000013969,7,2084,2345,261,05-07-2021
1000013969,8,2146,2345,199,05-08-2021
1000013969,9,2210,2345,135,05-09-2021
1000013969,10,2276,2344,68,05-10-2021
1000013970,1,1742,2635,893,05-01-2021
1000013970,2,1794,2635,841,05-02-2021
1000013970,3,1848,2635,787,05-03-2021
1000013970,4,1904,2635,731,05-04-2021
1000013970,5,1961,2635,674,05-05-2021
1000013970,6,2020,2635,615,05-06-2021
1000013970,7,2080,2635,555,05-07-2021
1000013970,8,2143,2635,492,05-08-2021
1000013970,9,2207,2635,428,05-09-2021
1000013970,10,2273,2635,362,05-10-2021
1000013970,11,2341,2635,294,05-11-2021
1000013970,12,2411,2635,224,05-12-2021
1000013970,13,2484,2635,151,05-01-2022
1000013970,14,2557,2634,77,05-02-2022
1000013971,1,0,258,258,05-01-2021
1000013971,2,0,258,258,05-02-2021
1000013971,3,0,258,258,05-03-2021
1000013971,4,0,258,258,05-04-2021
1000013971,5,0,258,258,05-05-2021
1000013971,6,0,258,258,05-06-2021
1000013971,7,4232,4490,258,05-07-2021
1000013971,8,4360,4491,131,05-08-2021
1000013972,1,2810,3776,966,05-01-2021
1000013972,2,2894,3776,882,05-02-2021
1000013972,3,2981,3776,795,05-03-2021
1000013972,4,3070,3776,706,05-04-2021
1000013972,5,3162,3776,614,05-05-2021
1000013972,6,3257,3776,519,05-06-2021
1000013972,7,3355,3776,421,05-07-2021
1000013972,8,3456,3776,320,05-08-2021
1000013972,9,3559,3776,217,05-09-2021
1000013972,10,3667,3777,110,05-10-2021
1000013973,1,1266,1604,338,05-01-2021
1000013973,2,1304,1604,300,05-02-2021
1000013973,3,1343,1604,261,05-03-2021
1000013973,4,1384,1604,220,05-04-2021
1000013973,5,1425,1604,179,05-05-2021
1000013973,6,1468,1604,136,05-06-2021
1000013973,7,1512,1604,92,05-07-2021
1000013973,8,1560,1607,47,05-08-2021
1000013974,1,3036,3417,381,05-01-2021
1000013974,2,3127,3417,290,05-02-2021
1000013974,3,3221,3417,196,05-03-2021
1000013974,4,3316,3415,99,05-04-2021
1000013975,1,0,372,372,05-01-2021
1000013975,2,0,372,372,05-02-2021
1000013975,3,0,372,372,05-03-2021
1000013975,4,0,372,372,05-04-2021
1000013975,5,0,372,372,05-05-2021
1000013975,6,0,372,372,05-06-2021
1000013975,7,1917,2289,372,05-07-2021
1000013975,8,1975,2289,314,05-08-2021
1000013975,9,2034,2289,255,05-09-2021
1000013975,10,2095,2289,194,05-10-2021
1000013975,11,2158,2289,131,05-11-2021
1000013975,12,2221,2288,67,05-12-2021
1000013976,1,987,1250,263,05-01-2021
1000013976,2,1016,1250,234,05-02-2021
1000013976,3,1047,1250,203,05-03-2021
1000013976,4,1078,1250,172,05-04-2021
1000013976,5,1111,1250,139,05-05-2021
1000013976,6,1144,1250,106,05-06-2021
1000013976,7,1178,1250,72,05-07-2021
1000013976,8,1213,1249,36,05-08-2021
1000013977,1,0,390,390,05-01-2021
1000013977,2,0,390,390,05-02-2021
1000013977,3,0,390,390,05-03-2021
1000013977,4,0,390,390,05-04-2021
1000013977,5,0,390,390,05-05-2021
1000013977,6,0,390,390,05-06-2021
1000013977,7,3107,3497,390,05-07-2021
1000013977,8,3200,3497,297,05-08-2021
1000013977,9,3296,3497,201,05-09-2021
1000013977,10,3397,3498,101,05-10-2021
1000013978,1,0,923,923,05-01-2021
1000013978,2,0,923,923,05-02-2021
1000013978,3,0,923,923,05-03-2021
1000013978,4,0,923,923,05-04-2021
1000013978,5,0,923,923,05-05-2021
1000013978,6,0,923,923,05-06-2021
1000013978,7,4014,4937,923,05-07-2021
1000013978,8,4135,4937,802,05-08-2021
1000013978,9,4259,4937,678,05-09-2021
1000013978,10,4386,4937,551,05-10-2021
1000013978,11,4518,4937,419,05-11-2021
1000013978,12,4654,4937,283,05-12-2021
1000013978,13,4792,4936,144,05-01-2022
1000013979,1,0,1030,1030,05-01-2021
1000013979,2,0,1030,1030,05-02-2021
1000013979,3,0,1030,1030,05-03-2021
1000013979,4,0,1030,1030,05-04-2021
1000013979,5,0,1030,1030,05-05-2021
1000013979,6,0,1030,1030,05-06-2021
1000013979,7,3863,4893,1030,05-07-2021
1000013979,8,3979,4893,914,05-08-2021
1000013979,9,4098,4893,795,05-09-2021
1000013979,10,4221,4893,672,05-10-2021
1000013979,11,4347,4893,546,05-11-2021
1000013979,12,4478,4893,415,05-12-2021
1000013979,13,4612,4893,281,05-01-2022
1000013979,14,4748,4890,142,05-02-2022
1000013980,1,983,1246,263,05-01-2021
1000013980,2,1013,1246,233,05-02-2021
1000013980,3,1043,1246,203,05-03-2021
1000013980,4,1075,1246,171,05-04-2021
1000013980,5,1107,1246,139,05-05-2021
1000013980,6,1140,1246,106,05-06-2021
1000013980,7,1174,1246,72,05-07-2021
1000013980,8,1215,1250,35,05-08-2021
1000013981,1,0,882,882,05-01-2021
1000013981,2,0,882,882,05-02-2021
1000013981,3,0,882,882,05-03-2021
1000013981,4,0,882,882,05-04-2021
1000013981,5,0,882,882,05-05-2021
1000013981,6,0,882,882,05-06-2021
1000013981,7,3838,4720,882,05-07-2021
1000013981,8,3953,4720,767,05-08-2021
1000013981,9,4071,4720,649,05-09-2021
1000013981,10,4194,4720,526,05-10-2021
1000013981,11,4319,4720,401,05-11-2021
1000013981,12,4449,4720,271,05-12-2021
1000013981,13,4585,4722,137,05-01-2022
1000013982,1,914,1229,315,05-01-2021
1000013982,2,942,1229,287,05-02-2021
1000013982,3,970,1229,259,05-03-2021
1000013982,4,999,1229,230,05-04-2021
1000013982,5,1029,1229,200,05-05-2021
1000013982,6,1060,1229,169,05-06-2021
1000013982,7,1092,1229,137,05-07-2021
1000013982,8,1125,1229,104,05-08-2021
1000013982,9,1158,1229,71,05-09-2021
1000013982,10,1197,1232,35,05-10-2021
1000013983,1,0,197,197,05-01-2021
1000013983,2,0,197,197,05-02-2021
1000013983,3,0,197,197,05-03-2021
1000013983,4,0,197,197,05-04-2021
1000013983,5,0,197,197,05-05-2021
1000013983,6,0,197,197,05-06-2021
1000013983,7,3233,3430,197,05-07-2021
1000013983,8,3331,3431,100,05-08-2021
1000013984,1,0,1030,1030,05-01-2021
1000013984,2,0,1030,1030,05-02-2021
1000013984,3,0,1030,1030,05-03-2021
1000013984,4,0,1030,1030,05-04-2021
1000013984,5,0,1030,1030,05-05-2021
1000013984,6,0,1030,1030,05-06-2021
1000013984,7,3863,4893,1030,05-07-2021
1000013984,8,3979,4893,914,05-08-2021
1000013984,9,4098,4893,795,05-09-2021
1000013984,10,4221,4893,672,05-10-2021
1000013984,11,4347,4893,546,05-11-2021
1000013984,12,4478,4893,415,05-12-2021
1000013984,13,4612,4893,281,05-01-2022
1000013984,14,4748,4890,142,05-02-2022
1000013985,1,3098,3287,189,05-01-2021
1000013985,2,3192,3287,95,05-02-2021
1000013986,1,2121,2387,266,05-01-2021
1000013986,2,2184,2387,203,05-02-2021
1000013986,3,2250,2387,137,05-03-2021
1000013986,4,2319,2388,69,05-04-2021
1000013987,1,895,1276,381,05-01-2021
1000013987,2,922,1276,354,05-02-2021
1000013987,3,950,1276,326,05-03-2021
1000013987,4,978,1276,298,05-04-2021
1000013987,5,1007,1276,269,05-05-2021
1000013987,6,1038,1276,238,05-06-2021
1000013987,7,1069,1276,207,05-07-2021
1000013987,8,1101,1276,175,05-08-2021
1000013987,9,1134,1276,142,05-09-2021
1000013987,10,1168,1276,108,05-10-2021
1000013987,11,1203,1276,73,05-11-2021
1000013987,12,1235,1272,37,05-12-2021
1000013988,1,1700,2571,871,05-01-2021
1000013988,2,1751,2571,820,05-02-2021
1000013988,3,1803,2571,768,05-03-2021
1000013988,4,1857,2571,714,05-04-2021
1000013988,5,1913,2571,658,05-05-2021
1000013988,6,1970,2571,601,05-06-2021
1000013988,7,2029,2571,542,05-07-2021
1000013988,8,2090,2571,481,05-08-2021
1000013988,9,2153,2571,418,05-09-2021
1000013988,10,2218,2571,353,05-10-2021
1000013988,11,2284,2571,287,05-11-2021
1000013988,12,2353,2571,218,05-12-2021
1000013988,13,2423,2571,148,05-01-2022
1000013988,14,2501,2575,74,05-02-2022
1000013989,1,2053,2311,258,05-01-2021
1000013989,2,2115,2311,196,05-02-2021
1000013989,3,2178,2311,133,05-03-2021
1000013989,4,2246,2313,67,05-04-2021
1000013990,1,1045,1176,131,05-01-2021
1000013990,2,1076,1176,100,05-02-2021
1000013990,3,1108,1176,68,05-03-2021
1000013990,4,1142,1176,34,05-04-2021
1000013991,1,852,1079,227,05-01-2021
1000013991,2,877,1079,202,05-02-2021
1000013991,3,904,1079,175,05-03-2021
1000013991,4,931,1079,148,05-04-2021
1000013991,5,959,1079,120,05-05-2021
1000013991,6,987,1079,92,05-06-2021
1000013991,7,1017,1079,62,05-07-2021
1000013991,8,1047,1078,31,05-08-2021
1000013992,1,1686,2705,1019,05-01-2021
1000013992,2,1736,2705,969,05-02-2021
1000013992,3,1788,2705,917,05-03-2021
1000013992,4,1842,2705,863,05-04-2021
1000013992,5,1897,2705,808,05-05-2021
1000013992,6,1954,2705,751,05-06-2021
1000013992,7,2013,2705,692,05-07-2021
1000013992,8,2073,2705,632,05-08-2021
1000013992,9,2135,2705,570,05-09-2021
1000013992,10,2199,2705,506,05-10-2021
1000013992,11,2265,2705,440,05-11-2021
1000013992,12,2333,2705,372,05-12-2021
1000013992,13,2403,2705,302,05-01-2022
1000013992,14,2475,2705,230,05-02-2022
1000013992,15,2550,2705,155,05-03-2022
1000013992,16,2631,2708,77,05-04-2022
1000013993,1,1376,1743,367,05-01-2021
1000013993,2,1417,1743,326,05-02-2021
1000013993,3,1460,1743,283,05-03-2021
1000013993,4,1504,1743,239,05-04-2021
1000013993,5,1549,1743,194,05-05-2021
1000013993,6,1595,1743,148,05-06-2021
1000013993,7,1643,1743,100,05-07-2021
1000013993,8,1688,1739,51,05-08-2021
1000013994,1,955,1210,255,05-01-2021
1000013994,2,984,1210,226,05-02-2021
1000013994,3,1013,1210,197,05-03-2021
1000013994,4,1044,1210,166,05-04-2021
1000013994,5,1075,1210,135,05-05-2021
1000013994,6,1107,1210,103,05-06-2021
1000013994,7,1141,1210,69,05-07-2021
1000013994,8,1173,1208,35,05-08-2021
1000013995,1,986,1177,191,05-01-2021
1000013995,2,1015,1177,162,05-02-2021
1000013995,3,1046,1177,131,05-03-2021
1000013995,4,1077,1177,100,05-04-2021
1000013995,5,1109,1177,68,05-05-2021
1000013995,6,1145,1179,34,05-06-2021
1000013996,1,932,1181,249,05-01-2021
1000013996,2,960,1181,221,05-02-2021
1000013996,3,989,1181,192,05-03-2021
1000013996,4,1019,1181,162,05-04-2021
1000013996,5,1049,1181,132,05-05-2021
1000013996,6,1081,1181,100,05-06-2021
1000013996,7,1113,1181,68,05-07-2021
1000013996,8,1145,1178,33,05-08-2021
1000013997,1,0,588,588,05-01-2021
1000013997,2,0,588,588,05-02-2021
1000013997,3,0,588,588,05-03-2021
1000013997,4,0,588,588,05-04-2021
1000013997,5,0,588,588,05-05-2021
1000013997,6,0,588,588,05-06-2021
1000013997,7,2559,3147,588,05-07-2021
1000013997,8,2636,3147,511,05-08-2021
1000013997,9,2715,3147,432,05-09-2021
1000013997,10,2796,3147,351,05-10-2021
1000013997,11,2880,3147,267,05-11-2021
1000013997,12,2966,3147,181,05-12-2021
1000013997,13,3055,3147,92,05-01-2022
1000013998,1,2053,2311,258,05-01-2021
1000013998,2,2115,2311,196,05-02-2021
1000013998,3,2178,2311,133,05-03-2021
1000013998,4,2246,2313,67,05-04-2021
1000013999,1,0,264,264,05-01-2021
1000013999,2,0,264,264,05-02-2021
1000013999,3,0,264,264,05-03-2021
1000013999,4,0,264,264,05-04-2021
1000013999,5,0,264,264,05-05-2021
1000013999,6,0,264,264,05-06-2021
1000013999,7,4332,4596,264,05-07-2021
1000013999,8,4463,4597,134,05-08-2021
1000014000,1,0,194,194,05-01-2021
1000014000,2,0,194,194,05-02-2021
1000014000,3,0,194,194,05-03-2021
1000014000,4,0,194,194,05-04-2021
1000014000,5,0,194,194,05-05-2021
1000014000,6,0,194,194,05-06-2021
1000014000,7,2096,2290,194,05-07-2021
1000014000,8,2159,2290,131,05-08-2021
1000014000,9,2223,2290,67,05-09-2021
1000014001,1,1842,2475,633,05-01-2021
1000014001,2,1897,2475,578,05-02-2021
1000014001,3,1954,2475,521,05-03-2021
1000014001,4,2012,2475,463,05-04-2021
1000014001,5,2073,2475,402,05-05-2021
1000014001,6,2135,2475,340,05-06-2021
1000014001,7,2199,2475,276,05-07-2021
1000014001,8,2265,2475,210,05-08-2021
1000014001,9,2333,2475,142,05-09-2021
1000014001,10,2400,2472,72,05-10-2021
1000014002,1,2102,2366,264,05-01-2021
1000014002,2,2165,2366,201,05-02-2021
1000014002,3,2230,2366,136,05-03-2021
1000014002,4,2298,2366,68,05-04-2021
1000014003,1,0,718,718,05-01-2021
1000014003,2,0,718,718,05-02-2021
1000014003,3,0,718,718,05-03-2021
1000014003,4,0,718,718,05-04-2021
1000014003,5,0,718,718,05-05-2021
1000014003,6,0,718,718,05-06-2021
1000014003,7,3703,4421,718,05-07-2021
1000014003,8,3814,4421,607,05-08-2021
1000014003,9,3928,4421,493,05-09-2021
1000014003,10,4046,4421,375,05-10-2021
1000014003,11,4167,4421,254,05-11-2021
1000014003,12,4289,4418,129,05-12-2021
1000014004,1,0,381,381,05-01-2021
1000014004,2,0,381,381,05-02-2021
1000014004,3,0,381,381,05-03-2021
1000014004,4,0,381,381,05-04-2021
1000014004,5,0,381,381,05-05-2021
1000014004,6,0,381,381,05-06-2021
1000014004,7,1963,2344,381,05-07-2021
1000014004,8,2022,2344,322,05-08-2021
1000014004,9,2083,2344,261,05-09-2021
1000014004,10,2145,2344,199,05-10-2021
1000014004,11,2209,2344,135,05-11-2021
1000014004,12,2278,2346,68,05-12-2021
1000014005,1,0,266,266,05-01-2021
1000014005,2,0,266,266,05-02-2021
1000014005,3,0,266,266,05-03-2021
1000014005,4,0,266,266,05-04-2021
1000014005,5,0,266,266,05-05-2021
1000014005,6,0,266,266,05-06-2021
1000014005,7,4372,4638,266,05-07-2021
1000014005,8,4502,4637,135,05-08-2021
1000014006,1,0,137,137,05-01-2021
1000014006,2,0,137,137,05-02-2021
1000014006,3,0,137,137,05-03-2021
1000014006,4,0,137,137,05-04-2021
1000014006,5,0,137,137,05-05-2021
1000014006,6,0,137,137,05-06-2021
1000014006,7,4554,4691,137,05-07-2021
1000014007,1,895,1276,381,05-01-2021
1000014007,2,922,1276,354,05-02-2021
1000014007,3,950,1276,326,05-03-2021
1000014007,4,978,1276,298,05-04-2021
1000014007,5,1007,1276,269,05-05-2021
1000014007,6,1038,1276,238,05-06-2021
1000014007,7,1069,1276,207,05-07-2021
1000014007,8,1101,1276,175,05-08-2021
1000014007,9,1134,1276,142,05-09-2021
1000014007,10,1168,1276,108,05-10-2021
1000014007,11,1203,1276,73,05-11-2021
1000014007,12,1235,1272,37,05-12-2021
1000014008,1,0,95,95,05-01-2021
1000014008,2,0,95,95,05-02-2021
1000014008,3,0,95,95,05-03-2021
1000014008,4,0,95,95,05-04-2021
1000014008,5,0,95,95,05-05-2021
1000014008,6,0,95,95,05-06-2021
1000014008,7,3170,3265,95,05-07-2021
1000014009,1,935,1256,321,05-01-2021
1000014009,2,963,1256,293,05-02-2021
1000014009,3,991,1256,265,05-03-2021
1000014009,4,1021,1256,235,05-04-2021
1000014009,5,1052,1256,204,05-05-2021
1000014009,6,1083,1256,173,05-06-2021
1000014009,7,1116,1256,140,05-07-2021
1000014009,8,1149,1256,107,05-08-2021
1000014009,9,1184,1256,72,05-09-2021
1000014009,10,1222,1258,36,05-10-2021
1000014010,1,804,1081,277,05-01-2021
1000014010,2,829,1081,252,05-02-2021
1000014010,3,853,1081,228,05-03-2021
1000014010,4,879,1081,202,05-04-2021
1000014010,5,905,1081,176,05-05-2021
1000014010,6,933,1081,148,05-06-2021
1000014010,7,961,1081,120,05-07-2021
1000014010,8,989,1081,92,05-08-2021
1000014010,9,1019,1081,62,05-09-2021
1000014010,10,1046,1077,31,05-10-2021
1000014011,1,0,372,372,05-01-2021
1000014011,2,0,372,372,05-02-2021
1000014011,3,0,372,372,05-03-2021
1000014011,4,0,372,372,05-04-2021
1000014011,5,0,372,372,05-05-2021
1000014011,6,0,372,372,05-06-2021
1000014011,7,1917,2289,372,05-07-2021
1000014011,8,1975,2289,314,05-08-2021
1000014011,9,2034,2289,255,05-09-2021
1000014011,10,2095,2289,194,05-10-2021
1000014011,11,2158,2289,131,05-11-2021
1000014011,12,2221,2288,67,05-12-2021
1000014012,1,2005,2257,252,05-01-2021
1000014012,2,2065,2257,192,05-02-2021
1000014012,3,2127,2257,130,05-03-2021
1000014012,4,2192,2256,64,05-04-2021
1000014013,1,1162,1757,595,05-01-2021
1000014013,2,1197,1757,560,05-02-2021
1000014013,3,1232,1757,525,05-03-2021
1000014013,4,1269,1757,488,05-04-2021
1000014013,5,1308,1757,449,05-05-2021
1000014013,6,1347,1757,410,05-06-2021
1000014013,7,1387,1757,370,05-07-2021
1000014013,8,1429,1757,328,05-08-2021
1000014013,9,1472,1757,285,05-09-2021
1000014013,10,1516,1757,241,05-10-2021
1000014013,11,1561,1757,196,05-11-2021
1000014013,12,1608,1757,149,05-12-2021
1000014013,13,1656,1757,101,05-01-2022
1000014013,14,1699,1750,51,05-02-2022
1000014014,1,1149,1544,395,05-01-2021
1000014014,2,1183,1544,361,05-02-2021
1000014014,3,1219,1544,325,05-03-2021
1000014014,4,1255,1544,289,05-04-2021
1000014014,5,1293,1544,251,05-05-2021
1000014014,6,1332,1544,212,05-06-2021
1000014014,7,1372,1544,172,05-07-2021
1000014014,8,1413,1544,131,05-08-2021
1000014014,9,1455,1544,89,05-09-2021
1000014014,10,1503,1548,45,05-10-2021
1000014015,1,0,134,134,05-01-2021
1000014015,2,0,134,134,05-02-2021
1000014015,3,0,134,134,05-03-2021
1000014015,4,0,134,134,05-04-2021
1000014015,5,0,134,134,05-05-2021
1000014015,6,0,134,134,05-06-2021
1000014015,7,4463,4597,134,05-07-2021
1000014016,1,1784,2699,915,05-01-2021
1000014016,2,1838,2699,861,05-02-2021
1000014016,3,1893,2699,806,05-03-2021
1000014016,4,1950,2699,749,05-04-2021
1000014016,5,2008,2699,691,05-05-2021
1000014016,6,2069,2699,630,05-06-2021
1000014016,7,2131,2699,568,05-07-2021
1000014016,8,2195,2699,504,05-08-2021
1000014016,9,2260,2699,439,05-09-2021
1000014016,10,2328,2699,371,05-10-2021
1000014016,11,2398,2699,301,05-11-2021
1000014016,12,2470,2699,229,05-12-2021
1000014016,13,2544,2699,155,05-01-2022
1000014016,14,2617,2695,78,05-02-2022
1000014017,1,957,1212,255,05-01-2021
1000014017,2,985,1212,227,05-02-2021
1000014017,3,1015,1212,197,05-03-2021
1000014017,4,1045,1212,167,05-04-2021
1000014017,5,1077,1212,135,05-05-2021
1000014017,6,1109,1212,103,05-06-2021
1000014017,7,1142,1212,70,05-07-2021
1000014017,8,1180,1214,34,05-08-2021
1000014018,1,1721,2603,882,05-01-2021
1000014018,2,1772,2603,831,05-02-2021
1000014018,3,1826,2603,777,05-03-2021
1000014018,4,1880,2603,723,05-04-2021
1000014018,5,1937,2603,666,05-05-2021
1000014018,6,1995,2603,608,05-06-2021
1000014018,7,2055,2603,548,05-07-2021
1000014018,8,2116,2603,487,05-08-2021
1000014018,9,2180,2603,423,05-09-2021
1000014018,10,2245,2603,358,05-10-2021
1000014018,11,2313,2603,290,05-11-2021
1000014018,12,2382,2603,221,05-12-2021
1000014018,13,2453,2603,150,05-01-2022
1000014018,14,2534,2610,76,05-02-2022
1000014019,1,0,762,762,05-01-2021
1000014019,2,0,762,762,05-02-2021
1000014019,3,0,762,762,05-03-2021
1000014019,4,0,762,762,05-04-2021
1000014019,5,0,762,762,05-05-2021
1000014019,6,0,762,762,05-06-2021
1000014019,7,3927,4689,762,05-07-2021
1000014019,8,4045,4689,644,05-08-2021
1000014019,9,4166,4689,523,05-09-2021
1000014019,10,4291,4689,398,05-10-2021
1000014019,11,4420,4689,269,05-11-2021
1000014019,12,4551,4688,137,05-12-2021
1000014020,1,1664,2670,1006,05-01-2021
1000014020,2,1714,2670,956,05-02-2021
1000014020,3,1765,2670,905,05-03-2021
1000014020,4,1818,2670,852,05-04-2021
1000014020,5,1873,2670,797,05-05-2021
1000014020,6,1929,2670,741,05-06-2021
1000014020,7,1987,2670,683,05-07-2021
1000014020,8,2046,2670,624,05-08-2021
1000014020,9,2108,2670,562,05-09-2021
1000014020,10,2171,2670,499,05-10-2021
1000014020,11,2236,2670,434,05-11-2021
1000014020,12,2303,2670,367,05-12-2021
1000014020,13,2372,2670,298,05-01-2022
1000014020,14,2444,2670,226,05-02-2022
1000014020,15,2517,2670,153,05-03-2022
1000014020,16,2588,2666,78,05-04-2022
1000014021,1,1562,1758,196,05-01-2021
1000014021,2,1609,1758,149,05-02-2021
1000014021,3,1657,1758,101,05-03-2021
1000014021,4,1706,1757,51,05-04-2021
1000014022,1,1917,2289,372,05-01-2021
1000014022,2,1975,2289,314,05-02-2021
1000014022,3,2034,2289,255,05-03-2021
1000014022,4,2095,2289,194,05-04-2021
1000014022,5,2158,2289,131,05-05-2021
1000014022,6,2221,2288,67,05-06-2021
1000014023,1,2056,2455,399,05-01-2021
1000014023,2,2118,2455,337,05-02-2021
1000014023,3,2181,2455,274,05-03-2021
1000014023,4,2247,2455,208,05-04-2021
1000014023,5,2314,2455,141,05-05-2021
1000014023,6,2384,2456,72,05-06-2021
1000014024,1,1002,1196,194,05-01-2021
1000014024,2,1032,1196,164,05-02-2021
1000014024,3,1063,1196,133,05-03-2021
1000014024,4,1095,1196,101,05-04-2021
1000014024,5,1127,1196,69,05-05-2021
1000014024,6,1159,1194,35,05-06-2021
1000014025,1,0,825,825,05-01-2021
1000014025,2,0,825,825,05-02-2021
1000014025,3,0,825,825,05-03-2021
1000014025,4,0,825,825,05-04-2021
1000014025,5,0,825,825,05-05-2021
1000014025,6,0,825,825,05-06-2021
1000014025,7,3095,3920,825,05-07-2021
1000014025,8,3187,3920,733,05-08-2021
1000014025,9,3283,3920,637,05-09-2021
1000014025,10,3381,3920,539,05-10-2021
1000014025,11,3483,3920,437,05-11-2021
1000014025,12,3587,3920,333,05-12-2021
1000014025,13,3695,3920,225,05-01-2022
1000014025,14,3804,3918,114,05-02-2022
1000014026,1,0,652,652,05-01-2021
1000014026,2,0,652,652,05-02-2021
1000014026,3,0,652,652,05-03-2021
1000014026,4,0,652,652,05-04-2021
1000014026,5,0,652,652,05-05-2021
1000014026,6,0,652,652,05-06-2021
1000014026,7,2442,3094,652,05-07-2021
1000014026,8,2516,3094,578,05-08-2021
1000014026,9,2591,3094,503,05-09-2021
1000014026,10,2669,3094,425,05-10-2021
1000014026,11,2749,3094,345,05-11-2021
1000014026,12,2831,3094,263,05-12-2021
1000014026,13,2916,3094,178,05-01-2022
1000014026,14,3003,3092,89,05-02-2022
1000014027,1,1144,1449,305,05-01-2021
1000014027,2,1178,1449,271,05-02-2021
1000014027,3,1213,1449,236,05-03-2021
1000014027,4,1250,1449,199,05-04-2021
1000014027,5,1287,1449,162,05-05-2021
1000014027,6,1326,1449,123,05-06-2021
1000014027,7,1366,1449,83,05-07-2021
1000014027,8,1410,1452,42,05-08-2021
1000014028,1,1346,1607,261,05-01-2021
1000014028,2,1386,1607,221,05-02-2021
1000014028,3,1428,1607,179,05-03-2021
1000014028,4,1471,1607,136,05-04-2021
1000014028,5,1515,1607,92,05-05-2021
1000014028,6,1560,1607,47,05-06-2021
1000014029,1,0,322,322,05-01-2021
1000014029,2,0,322,322,05-02-2021
1000014029,3,0,322,322,05-03-2021
1000014029,4,0,322,322,05-04-2021
1000014029,5,0,322,322,05-05-2021
1000014029,6,0,322,322,05-06-2021
1000014029,7,2023,2345,322,05-07-2021
1000014029,8,2083,2345,262,05-08-2021
1000014029,9,2146,2345,199,05-09-2021
1000014029,10,2210,2345,135,05-10-2021
1000014029,11,2278,2346,68,05-11-2021
1000014030,1,1610,2436,826,05-01-2021
1000014030,2,1659,2436,777,05-02-2021
1000014030,3,1709,2436,727,05-03-2021
1000014030,4,1760,2436,676,05-04-2021
1000014030,5,1813,2436,623,05-05-2021
1000014030,6,1867,2436,569,05-06-2021
1000014030,7,1923,2436,513,05-07-2021
1000014030,8,1981,2436,455,05-08-2021
1000014030,9,2040,2436,396,05-09-2021
1000014030,10,2101,2436,335,05-10-2021
1000014030,11,2164,2436,272,05-11-2021
1000014030,12,2229,2436,207,05-12-2021
1000014030,13,2296,2436,140,05-01-2022
1000014030,14,2365,2436,71,05-02-2022
1000014031,1,2056,2455,399,05-01-2021
1000014031,2,2118,2455,337,05-02-2021
1000014031,3,2181,2455,274,05-03-2021
1000014031,4,2247,2455,208,05-04-2021
1000014031,5,2314,2455,141,05-05-2021
1000014031,6,2384,2456,72,05-06-2021
1000014032,1,2005,2257,252,05-01-2021
1000014032,2,2065,2257,192,05-02-2021
1000014032,3,2127,2257,130,05-03-2021
1000014032,4,2192,2256,64,05-04-2021
1000014033,1,1245,1775,530,05-01-2021
1000014033,2,1282,1775,493,05-02-2021
1000014033,3,1321,1775,454,05-03-2021
1000014033,4,1360,1775,415,05-04-2021
1000014033,5,1401,1775,374,05-05-2021
1000014033,6,1443,1775,332,05-06-2021
1000014033,7,1487,1775,288,05-07-2021
1000014033,8,1531,1775,244,05-08-2021
1000014033,9,1577,1775,198,05-09-2021
1000014033,10,1624,1775,151,05-10-2021
1000014033,11,1673,1775,102,05-11-2021
1000014033,12,1723,1773,50,05-12-2021
1000014034,1,895,1276,381,05-01-2021
1000014034,2,922,1276,354,05-02-2021
1000014034,3,950,1276,326,05-03-2021
1000014034,4,978,1276,298,05-04-2021
1000014034,5,1007,1276,269,05-05-2021
1000014034,6,1038,1276,238,05-06-2021
1000014034,7,1069,1276,207,05-07-2021
1000014034,8,1101,1276,175,05-08-2021
1000014034,9,1134,1276,142,05-09-2021
1000014034,10,1168,1276,108,05-10-2021
1000014034,11,1203,1276,73,05-11-2021
1000014034,12,1235,1272,37,05-12-2021
1000014035,1,0,321,321,05-01-2021
1000014035,2,0,321,321,05-02-2021
1000014035,3,0,321,321,05-03-2021
1000014035,4,0,321,321,05-04-2021
1000014035,5,0,321,321,05-05-2021
1000014035,6,0,321,321,05-06-2021
1000014035,7,2019,2340,321,05-07-2021
1000014035,8,2079,2340,261,05-08-2021
1000014035,9,2141,2340,199,05-09-2021
1000014035,10,2206,2340,134,05-10-2021
1000014035,11,2271,2339,68,05-11-2021
1000014036,1,981,1242,261,05-01-2021
1000014036,2,1010,1242,232,05-02-2021
1000014036,3,1040,1242,202,05-03-2021
1000014036,4,1071,1242,171,05-04-2021
1000014036,5,1104,1242,138,05-05-2021
1000014036,6,1137,1242,105,05-06-2021
1000014036,7,1171,1242,71,05-07-2021
1000014036,8,1202,1238,36,05-08-2021
1000014037,1,0,687,687,05-01-2021
1000014037,2,0,687,687,05-02-2021
1000014037,3,0,687,687,05-03-2021
1000014037,4,0,687,687,05-04-2021
1000014037,5,0,687,687,05-05-2021
1000014037,6,0,687,687,05-06-2021
1000014037,7,2575,3262,687,05-07-2021
1000014037,8,2652,3262,610,05-08-2021
1000014037,9,2732,3262,530,05-09-2021
1000014037,10,2814,3262,448,05-10-2021
1000014037,11,2898,3262,364,05-11-2021
1000014037,12,2985,3262,277,05-12-2021
1000014037,13,3075,3262,187,05-01-2022
1000014037,14,3169,3264,95,05-02-2022
1000014038,1,981,1242,261,05-01-2021
1000014038,2,1010,1242,232,05-02-2021
1000014038,3,1040,1242,202,05-03-2021
1000014038,4,1071,1242,171,05-04-2021
1000014038,5,1104,1242,138,05-05-2021
1000014038,6,1137,1242,105,05-06-2021
1000014038,7,1171,1242,71,05-07-2021
1000014038,8,1202,1238,36,05-08-2021
1000014039,1,1052,1256,204,05-01-2021
1000014039,2,1083,1256,173,05-02-2021
1000014039,3,1116,1256,140,05-03-2021
1000014039,4,1149,1256,107,05-04-2021
1000014039,5,1184,1256,72,05-05-2021
1000014039,6,1222,1258,36,05-06-2021
1000014040,1,959,1289,330,05-01-2021
1000014040,2,988,1289,301,05-02-2021
1000014040,3,1018,1289,271,05-03-2021
1000014040,4,1048,1289,241,05-04-2021
1000014040,5,1080,1289,209,05-05-2021
1000014040,6,1112,1289,177,05-06-2021
1000014040,7,1145,1289,144,05-07-2021
1000014040,8,1180,1289,109,05-08-2021
1000014040,9,1215,1289,74,05-09-2021
1000014040,10,1249,1286,37,05-10-2021
1000014041,1,0,1001,1001,05-01-2021
1000014041,2,0,1001,1001,05-02-2021
1000014041,3,0,1001,1001,05-03-2021
1000014041,4,0,1001,1001,05-04-2021
1000014041,5,0,1001,1001,05-05-2021
1000014041,6,0,1001,1001,05-06-2021
1000014041,7,3755,4756,1001,05-07-2021
1000014041,8,3867,4756,889,05-08-2021
1000014041,9,3983,4756,773,05-09-2021
1000014041,10,4103,4756,653,05-10-2021
1000014041,11,4226,4756,530,05-11-2021
1000014041,12,4353,4756,403,05-12-2021
1000014041,13,4483,4756,273,05-01-2022
1000014041,14,4613,4751,138,05-02-2022
1000014042,1,957,1212,255,05-01-2021
1000014042,2,985,1212,227,05-02-2021
1000014042,3,1015,1212,197,05-03-2021
1000014042,4,1045,1212,167,05-04-2021
1000014042,5,1077,1212,135,05-05-2021
1000014042,6,1109,1212,103,05-06-2021
1000014042,7,1142,1212,70,05-07-2021
1000014042,8,1180,1214,34,05-08-2021
1000014043,1,0,610,610,05-01-2021
1000014043,2,0,610,610,05-02-2021
1000014043,3,0,610,610,05-03-2021
1000014043,4,0,610,610,05-04-2021
1000014043,5,0,610,610,05-05-2021
1000014043,6,0,610,610,05-06-2021
1000014043,7,2652,3262,610,05-07-2021
1000014043,8,2732,3262,530,05-08-2021
1000014043,9,2814,3262,448,05-09-2021
1000014043,10,2898,3262,364,05-10-2021
1000014043,11,2985,3262,277,05-11-2021
1000014043,12,3075,3262,187,05-12-2021
1000014043,13,3167,3262,95,05-01-2022
1000014044,1,0,687,687,05-01-2021
1000014044,2,0,687,687,05-02-2021
1000014044,3,0,687,687,05-03-2021
1000014044,4,0,687,687,05-04-2021
1000014044,5,0,687,687,05-05-2021
1000014044,6,0,687,687,05-06-2021
1000014044,7,2575,3262,687,05-07-2021
1000014044,8,2652,3262,610,05-08-2021
1000014044,9,2732,3262,530,05-09-2021
1000014044,10,2814,3262,448,05-10-2021
1000014044,11,2898,3262,364,05-11-2021
1000014044,12,2985,3262,277,05-12-2021
1000014044,13,3075,3262,187,05-01-2022
1000014044,14,3169,3264,95,05-02-2022
1000014045,1,1192,1265,73,05-01-2021
1000014045,2,1229,1265,36,05-02-2021
1000014046,1,0,261,261,05-01-2021
1000014046,2,0,261,261,05-02-2021
1000014046,3,0,261,261,05-03-2021
1000014046,4,0,261,261,05-04-2021
1000014046,5,0,261,261,05-05-2021
1000014046,6,0,261,261,05-06-2021
1000014046,7,2084,2345,261,05-07-2021
1000014046,8,2146,2345,199,05-08-2021
1000014046,9,2210,2345,135,05-09-2021
1000014046,10,2276,2344,68,05-10-2021
1000014047,1,955,1210,255,05-01-2021
1000014047,2,984,1210,226,05-02-2021
1000014047,3,1013,1210,197,05-03-2021
1000014047,4,1044,1210,166,05-04-2021
1000014047,5,1075,1210,135,05-05-2021
1000014047,6,1107,1210,103,05-06-2021
1000014047,7,1140,1210,70,05-07-2021
1000014047,8,1178,1212,34,05-08-2021
1000014048,1,1131,1433,302,05-01-2021
1000014048,2,1165,1433,268,05-02-2021
1000014048,3,1200,1433,233,05-03-2021
1000014048,4,1236,1433,197,05-04-2021
1000014048,5,1273,1433,160,05-05-2021
1000014048,6,1311,1433,122,05-06-2021
1000014048,7,1351,1433,82,05-07-2021
1000014048,8,1393,1434,41,05-08-2021
1000014049,1,1824,2600,776,05-01-2021
1000014049,2,1878,2600,722,05-02-2021
1000014049,3,1935,2600,665,05-03-2021
1000014049,4,1993,2600,607,05-04-2021
1000014049,5,2052,2600,548,05-05-2021
1000014049,6,2114,2600,486,05-06-2021
1000014049,7,2177,2600,423,05-07-2021
1000014049,8,2243,2600,357,05-08-2021
1000014049,9,2310,2600,290,05-09-2021
1000014049,10,2379,2600,221,05-10-2021
1000014049,11,2451,2600,149,05-11-2021
1000014049,12,2524,2600,76,05-12-2021
1000014050,1,1180,1784,604,05-01-2021
1000014050,2,1215,1784,569,05-02-2021
1000014050,3,1251,1784,533,05-03-2021
1000014050,4,1289,1784,495,05-04-2021
1000014050,5,1328,1784,456,05-05-2021
1000014050,6,1367,1784,417,05-06-2021
1000014050,7,1408,1784,376,05-07-2021
1000014050,8,1451,1784,333,05-08-2021
1000014050,9,1494,1784,290,05-09-2021
1000014050,10,1539,1784,245,05-10-2021
1000014050,11,1585,1784,199,05-11-2021
1000014050,12,1633,1784,151,05-12-2021
1000014050,13,1682,1784,102,05-01-2022
1000014050,14,1726,1778,52,05-02-2022
1000014051,1,0,376,376,05-01-2021
1000014051,2,895,1276,381,05-02-2021
1000014051,3,922,1276,354,05-03-2021
1000014051,4,950,1276,326,05-04-2021
1000014051,5,978,1276,298,05-05-2021
1000014051,6,1007,1276,269,05-06-2021
1000014051,7,1038,1276,238,05-07-2021
1000014051,8,1069,1276,207,05-08-2021
1000014051,9,1101,1276,175,05-09-2021
1000014051,10,1134,1276,142,05-10-2021
1000014051,11,1168,1276,108,05-11-2021
1000014051,12,1203,1276,73,05-12-2021
1000014051,13,1235,1272,37,05-01-2022
1000014052,1,0,399,399,05-01-2021
1000014052,2,0,399,399,05-02-2021
1000014052,3,0,399,399,05-03-2021
1000014052,4,0,399,399,05-04-2021
1000014052,5,0,399,399,05-05-2021
1000014052,6,0,399,399,05-06-2021
1000014052,7,4303,4702,399,05-07-2021
1000014052,8,4432,4702,270,05-08-2021
1000014052,9,4565,4702,137,05-09-2021
1000014053,1,1512,1702,190,05-01-2021
1000014053,2,1558,1702,144,05-02-2021
1000014053,3,1604,1702,98,05-03-2021
1000014053,4,1652,1701,49,05-04-2021
1000014054,1,0,395,395,05-01-2021
1000014054,2,0,395,395,05-02-2021
1000014054,3,0,395,395,05-03-2021
1000014054,4,0,395,395,05-04-2021
1000014054,5,0,395,395,05-05-2021
1000014054,6,0,395,395,05-06-2021
1000014054,7,4256,4651,395,05-07-2021
1000014054,8,4384,4651,267,05-08-2021
1000014054,9,4516,4651,135,05-09-2021
1000014055,1,0,432,432,05-01-2021
1000014055,2,0,432,432,05-02-2021
1000014055,3,0,432,432,05-03-2021
1000014055,4,0,432,432,05-04-2021
1000014055,5,0,432,432,05-05-2021
1000014055,6,0,432,432,05-06-2021
1000014055,7,2710,3142,432,05-07-2021
1000014055,8,2792,3142,350,05-08-2021
1000014055,9,2875,3142,267,05-09-2021
1000014055,10,2962,3142,180,05-10-2021
1000014055,11,3049,3140,91,05-11-2021
1000014056,1,895,1276,381,05-01-2021
1000014056,2,922,1276,354,05-02-2021
1000014056,3,950,1276,326,05-03-2021
1000014056,4,978,1276,298,05-04-2021
1000014056,5,1007,1276,269,05-05-2021
1000014056,6,1038,1276,238,05-06-2021
1000014056,7,1069,1276,207,05-07-2021
1000014056,8,1101,1276,175,05-08-2021
1000014056,9,1134,1276,142,05-09-2021
1000014056,10,1168,1276,108,05-10-2021
1000014056,11,1203,1276,73,05-11-2021
1000014056,12,1235,1272,37,05-12-2021
1000014057,1,1131,1433,302,05-01-2021
1000014057,2,1165,1433,268,05-02-2021
1000014057,3,1200,1433,233,05-03-2021
1000014057,4,1236,1433,197,05-04-2021
1000014057,5,1273,1433,160,05-05-2021
1000014057,6,1311,1433,122,05-06-2021
1000014057,7,1351,1433,82,05-07-2021
1000014057,8,1393,1434,41,05-08-2021
1000014058,1,0,260,260,05-01-2021
1000014058,2,0,260,260,05-02-2021
1000014058,3,0,260,260,05-03-2021
1000014058,4,0,260,260,05-04-2021
1000014058,5,0,260,260,05-05-2021
1000014058,6,0,260,260,05-06-2021
1000014058,7,4273,4533,260,05-07-2021
1000014058,8,4401,4533,132,05-08-2021
1000014059,1,1002,1196,194,05-01-2021
1000014059,2,1032,1196,164,05-02-2021
1000014059,3,1063,1196,133,05-03-2021
1000014059,4,1095,1196,101,05-04-2021
1000014059,5,1127,1196,69,05-05-2021
1000014059,6,1159,1194,35,05-06-2021
1000014060,1,2053,2311,258,05-01-2021
1000014060,2,2115,2311,196,05-02-2021
1000014060,3,2178,2311,133,05-03-2021
1000014060,4,2246,2313,67,05-04-2021
1000014061,1,0,399,399,05-01-2021
1000014061,2,0,399,399,05-02-2021
1000014061,3,0,399,399,05-03-2021
1000014061,4,0,399,399,05-04-2021
1000014061,5,0,399,399,05-05-2021
1000014061,6,0,399,399,05-06-2021
1000014061,7,4303,4702,399,05-07-2021
1000014061,8,4432,4702,270,05-08-2021
1000014061,9,4565,4702,137,05-09-2021
1000014062,1,0,479,479,05-01-2021
1000014062,2,0,479,479,05-02-2021
1000014062,3,0,479,479,05-03-2021
1000014062,4,0,479,479,05-04-2021
1000014062,5,0,479,479,05-05-2021
1000014062,6,0,479,479,05-06-2021
1000014062,7,3007,3486,479,05-07-2021
1000014062,8,3097,3486,389,05-08-2021
1000014062,9,3190,3486,296,05-09-2021
1000014062,10,3286,3486,200,05-10-2021
1000014062,11,3383,3484,101,05-11-2021
1000014063,1,2230,3373,1143,05-01-2021
1000014063,2,2297,3373,1076,05-02-2021
1000014063,3,2366,3373,1007,05-03-2021
1000014063,4,2437,3373,936,05-04-2021
1000014063,5,2510,3373,863,05-05-2021
1000014063,6,2585,3373,788,05-06-2021
1000014063,7,2663,3373,710,05-07-2021
1000014063,8,2743,3373,630,05-08-2021
1000014063,9,2825,3373,548,05-09-2021
1000014063,10,2910,3373,463,05-10-2021
1000014063,11,2997,3373,376,05-11-2021
1000014063,12,3087,3373,286,05-12-2021
1000014063,13,3179,3373,194,05-01-2022
1000014063,14,3271,3369,98,05-02-2022
1000014064,1,1487,2249,762,05-01-2021
1000014064,2,1531,2249,718,05-02-2021
1000014064,3,1577,2249,672,05-03-2021
1000014064,4,1625,2249,624,05-04-2021
1000014064,5,1673,2249,576,05-05-2021
1000014064,6,1724,2249,525,05-06-2021
1000014064,7,1775,2249,474,05-07-2021
1000014064,8,1829,2249,420,05-08-2021
1000014064,9,1884,2249,365,05-09-2021
1000014064,10,1940,2249,309,05-10-2021
1000014064,11,1998,2249,251,05-11-2021
1000014064,12,2058,2249,191,05-12-2021
1000014064,13,2120,2249,129,05-01-2022
1000014064,14,2183,2248,65,05-02-2022
1000014065,1,1704,2734,1030,05-01-2021
1000014065,2,1755,2734,979,05-02-2021
1000014065,3,1807,2734,927,05-03-2021
1000014065,4,1862,2734,872,05-04-2021
1000014065,5,1917,2734,817,05-05-2021
1000014065,6,1975,2734,759,05-06-2021
1000014065,7,2034,2734,700,05-07-2021
1000014065,8,2095,2734,639,05-08-2021
1000014065,9,2158,2734,576,05-09-2021
1000014065,10,2223,2734,511,05-10-2021
1000014065,11,2290,2734,444,05-11-2021
1000014065,12,2358,2734,376,05-12-2021
1000014065,13,2429,2734,305,05-01-2022
1000014065,14,2502,2734,232,05-02-2022
1000014065,15,2577,2734,157,05-03-2022
1000014065,16,2660,2739,79,05-04-2022
1000014066,1,1142,1285,143,05-01-2021
1000014066,2,1176,1285,109,05-02-2021
1000014066,3,1211,1285,74,05-03-2021
1000014066,4,1246,1283,37,05-04-2021
1000014067,1,1487,2249,762,05-01-2021
1000014067,2,1531,2249,718,05-02-2021
1000014067,3,1577,2249,672,05-03-2021
1000014067,4,1625,2249,624,05-04-2021
1000014067,5,1673,2249,576,05-05-2021
1000014067,6,1724,2249,525,05-06-2021
1000014067,7,1775,2249,474,05-07-2021
1000014067,8,1829,2249,420,05-08-2021
1000014067,9,1884,2249,365,05-09-2021
1000014067,10,1940,2249,309,05-10-2021
1000014067,11,1998,2249,251,05-11-2021
1000014067,12,2058,2249,191,05-12-2021
1000014067,13,2120,2249,129,05-01-2022
1000014067,14,2183,2248,65,05-02-2022
1000014068,1,0,787,787,05-01-2021
1000014068,2,0,787,787,05-02-2021
1000014068,3,0,787,787,05-03-2021
1000014068,4,0,787,787,05-04-2021
1000014068,5,0,787,787,05-05-2021
1000014068,6,0,787,787,05-06-2021
1000014068,7,6273,7060,787,05-07-2021
1000014068,8,6461,7060,599,05-08-2021
1000014068,9,6655,7060,405,05-09-2021
1000014068,10,6855,7061,206,05-10-2021
1000014069,1,0,211,211,05-01-2021
1000014069,2,0,211,211,05-02-2021
1000014069,3,0,211,211,05-03-2021
1000014069,4,0,211,211,05-04-2021
1000014069,5,0,211,211,05-05-2021
1000014069,6,0,211,211,05-06-2021
1000014069,7,7030,7241,211,05-07-2021
1000014070,1,0,318,318,05-01-2021
1000014070,2,937,1259,322,05-02-2021
1000014070,3,965,1259,294,05-03-2021
1000014070,4,994,1259,265,05-04-2021
1000014070,5,1024,1259,235,05-05-2021
1000014070,6,1054,1259,205,05-06-2021
1000014070,7,1086,1259,173,05-07-2021
1000014070,8,1119,1259,140,05-08-2021
1000014070,9,1152,1259,107,05-09-2021
1000014070,10,1187,1259,72,05-10-2021
1000014070,11,1222,1259,37,05-11-2021
1000014071,1,2261,2399,138,05-01-2021
1000014071,2,2329,2399,70,05-02-2021
1000014072,1,0,272,272,05-01-2021
1000014072,2,0,272,272,05-02-2021
1000014072,3,0,272,272,05-03-2021
1000014072,4,0,272,272,05-04-2021
1000014072,5,0,272,272,05-05-2021
1000014072,6,0,272,272,05-06-2021
1000014072,7,1710,1982,272,05-07-2021
1000014072,8,1761,1982,221,05-08-2021
1000014072,9,1814,1982,168,05-09-2021
1000014072,10,1868,1982,114,05-10-2021
1000014072,11,1926,1984,58,05-11-2021
1000014073,1,2532,2686,154,05-01-2021
1000014073,2,2607,2685,78,05-02-2021
1000014074,1,1142,1285,143,05-01-2021
1000014074,2,1176,1285,109,05-02-2021
1000014074,3,1211,1285,74,05-03-2021
1000014074,4,1246,1283,37,05-04-2021
1000014075,1,2005,2257,252,05-01-2021
1000014075,2,2065,2257,192,05-02-2021
1000014075,3,2127,2257,130,05-03-2021
1000014075,4,2192,2256,64,05-04-2021
1000014076,1,0,272,272,05-01-2021
1000014076,2,0,272,272,05-02-2021
1000014076,3,0,272,272,05-03-2021
1000014076,4,0,272,272,05-04-2021
1000014076,5,0,272,272,05-05-2021
1000014076,6,0,272,272,05-06-2021
1000014076,7,2169,2441,272,05-07-2021
1000014076,8,2234,2441,207,05-08-2021
1000014076,9,2301,2441,140,05-09-2021
1000014076,10,2370,2441,71,05-10-2021
1000014077,1,0,194,194,05-01-2021
1000014077,2,0,194,194,05-02-2021
1000014077,3,0,194,194,05-03-2021
1000014077,4,0,194,194,05-04-2021
1000014077,5,0,194,194,05-05-2021
1000014077,6,0,194,194,05-06-2021
1000014077,7,2096,2290,194,05-07-2021
1000014077,8,2159,2290,131,05-08-2021
1000014077,9,2223,2290,67,05-09-2021
1000014078,1,0,128,128,05-01-2021
1000014078,2,0,128,128,05-02-2021
1000014078,3,0,128,128,05-03-2021
1000014078,4,0,128,128,05-04-2021
1000014078,5,0,128,128,05-05-2021
1000014078,6,0,128,128,05-06-2021
1000014078,7,2106,2234,128,05-07-2021
1000014078,8,2169,2234,65,05-08-2021
1000014079,1,1594,2142,548,05-01-2021
1000014079,2,1642,2142,500,05-02-2021
1000014079,3,1691,2142,451,05-03-2021
1000014079,4,1742,2142,400,05-04-2021
1000014079,5,1794,2142,348,05-05-2021
1000014079,6,1848,2142,294,05-06-2021
1000014079,7,1903,2142,239,05-07-2021
1000014079,8,1960,2142,182,05-08-2021
1000014079,9,2019,2142,123,05-09-2021
1000014079,10,2078,2140,62,05-10-2021
1000014080,1,3073,3669,596,05-01-2021
1000014080,2,3165,3669,504,05-02-2021
1000014080,3,3260,3669,409,05-03-2021
1000014080,4,3358,3669,311,05-04-2021
1000014080,5,3458,3669,211,05-05-2021
1000014080,6,3561,3668,107,05-06-2021
1000014081,1,0,711,711,05-01-2021
1000014081,2,0,711,711,05-02-2021
1000014081,3,0,711,711,05-03-2021
1000014081,4,0,711,711,05-04-2021
1000014081,5,0,711,711,05-05-2021
1000014081,6,0,711,711,05-06-2021
1000014081,7,3094,3805,711,05-07-2021
1000014081,8,3187,3805,618,05-08-2021
1000014081,9,3282,3805,523,05-09-2021
1000014081,10,3381,3805,424,05-10-2021
1000014081,11,3482,3805,323,05-11-2021
1000014081,12,3587,3805,218,05-12-2021
1000014081,13,3693,3804,111,05-01-2022
1000014082,1,1174,1674,500,05-01-2021
1000014082,2,1209,1674,465,05-02-2021
1000014082,3,1246,1674,428,05-03-2021
1000014082,4,1283,1674,391,05-04-2021
1000014082,5,1321,1674,353,05-05-2021
1000014082,6,1361,1674,313,05-06-2021
1000014082,7,1402,1674,272,05-07-2021
1000014082,8,1444,1674,230,05-08-2021
1000014082,9,1487,1674,187,05-09-2021
1000014082,10,1532,1674,142,05-10-2021
1000014082,11,1578,1674,96,05-11-2021
1000014082,12,1629,1678,49,05-12-2021
1000014083,1,959,1289,330,05-01-2021
1000014083,2,988,1289,301,05-02-2021
1000014083,3,1018,1289,271,05-03-2021
1000014083,4,1048,1289,241,05-04-2021
1000014083,5,1080,1289,209,05-05-2021
1000014083,6,1112,1289,177,05-06-2021
1000014083,7,1145,1289,144,05-07-2021
1000014083,8,1180,1289,109,05-08-2021
1000014083,9,1215,1289,74,05-09-2021
1000014083,10,1249,1286,37,05-10-2021
1000014084,1,0,131,131,05-01-2021
1000014084,2,0,131,131,05-02-2021
1000014084,3,0,131,131,05-03-2021
1000014084,4,0,131,131,05-04-2021
1000014084,5,0,131,131,05-05-2021
1000014084,6,0,131,131,05-06-2021
1000014084,7,2149,2280,131,05-07-2021
1000014084,8,2214,2280,66,05-08-2021
1000014085,1,1788,2549,761,05-01-2021
1000014085,2,1842,2549,707,05-02-2021
1000014085,3,1897,2549,652,05-03-2021
1000014085,4,1954,2549,595,05-04-2021
1000014085,5,2012,2549,537,05-05-2021
1000014085,6,2073,2549,476,05-06-2021
1000014085,7,2135,2549,414,05-07-2021
1000014085,8,2199,2549,350,05-08-2021
1000014085,9,2265,2549,284,05-09-2021
1000014085,10,2333,2549,216,05-10-2021
1000014085,11,2403,2549,146,05-11-2021
1000014085,12,2467,2541,74,05-12-2021
1000014086,1,937,1259,322,05-01-2021
1000014086,2,965,1259,294,05-02-2021
1000014086,3,994,1259,265,05-03-2021
1000014086,4,1024,1259,235,05-04-2021
1000014086,5,1054,1259,205,05-05-2021
1000014086,6,1086,1259,173,05-06-2021
1000014086,7,1119,1259,140,05-07-2021
1000014086,8,1152,1259,107,05-08-2021
1000014086,9,1187,1259,72,05-09-2021
1000014086,10,1222,1259,37,05-10-2021
1000014087,1,981,1242,261,05-01-2021
1000014087,2,1010,1242,232,05-02-2021
1000014087,3,1040,1242,202,05-03-2021
1000014087,4,1071,1242,171,05-04-2021
1000014087,5,1104,1242,138,05-05-2021
1000014087,6,1137,1242,105,05-06-2021
1000014087,7,1171,1242,71,05-07-2021
1000014087,8,1202,1238,36,05-08-2021
1000014088,1,937,1259,322,05-01-2021
1000014088,2,965,1259,294,05-02-2021
1000014088,3,994,1259,265,05-03-2021
1000014088,4,1024,1259,235,05-04-2021
1000014088,5,1054,1259,205,05-05-2021
1000014088,6,1086,1259,173,05-06-2021
1000014088,7,1119,1259,140,05-07-2021
1000014088,8,1152,1259,107,05-08-2021
1000014088,9,1187,1259,72,05-09-2021
1000014088,10,1222,1259,37,05-10-2021
1000014089,1,1381,1969,588,05-01-2021
1000014089,2,1422,1969,547,05-02-2021
1000014089,3,1465,1969,504,05-03-2021
1000014089,4,1509,1969,460,05-04-2021
1000014089,5,1554,1969,415,05-05-2021
1000014089,6,1601,1969,368,05-06-2021
1000014089,7,1649,1969,320,05-07-2021
1000014089,8,1698,1969,271,05-08-2021
1000014089,9,1749,1969,220,05-09-2021
1000014089,10,1802,1969,167,05-10-2021
1000014089,11,1856,1969,113,05-11-2021
1000014089,12,1916,1972,56,05-12-2021
1000014090,1,929,1109,180,05-01-2021
1000014090,2,957,1109,152,05-02-2021
1000014090,3,985,1109,124,05-03-2021
1000014090,4,1015,1109,94,05-04-2021
1000014090,5,1045,1109,64,05-05-2021
1000014090,6,1076,1108,32,05-06-2021
1000014091,1,0,328,328,05-01-2021
1000014091,2,0,328,328,05-02-2021
1000014091,3,0,328,328,05-03-2021
1000014091,4,0,328,328,05-04-2021
1000014091,5,0,328,328,05-05-2021
1000014091,6,0,328,328,05-06-2021
1000014091,7,3542,3870,328,05-07-2021
1000014091,8,3648,3870,222,05-08-2021
1000014091,9,3758,3871,113,05-09-2021
1000014092,1,2150,2420,270,05-01-2021
1000014092,2,2215,2420,205,05-02-2021
1000014092,3,2281,2420,139,05-03-2021
1000014092,4,2351,2422,71,05-04-2021
1000014093,1,1428,1809,381,05-01-2021
1000014093,2,1471,1809,338,05-02-2021
1000014093,3,1515,1809,294,05-03-2021
1000014093,4,1560,1809,249,05-04-2021
1000014093,5,1607,1809,202,05-05-2021
1000014093,6,1655,1809,154,05-06-2021
1000014093,7,1705,1809,104,05-07-2021
1000014093,8,1759,1811,52,05-08-2021
1000014094,1,2679,2842,163,05-01-2021
1000014094,2,2760,2843,83,05-02-2021
1000014095,1,937,1259,322,05-01-2021
1000014095,2,965,1259,294,05-02-2021
1000014095,3,994,1259,265,05-03-2021
1000014095,4,1024,1259,235,05-04-2021
1000014095,5,1054,1259,205,05-05-2021
1000014095,6,1086,1259,173,05-06-2021
1000014095,7,1119,1259,140,05-07-2021
1000014095,8,1152,1259,107,05-08-2021
1000014095,9,1187,1259,72,05-09-2021
1000014095,10,1222,1259,37,05-10-2021
1000014096,1,726,817,91,05-01-2021
1000014096,2,748,817,69,05-02-2021
1000014096,3,770,817,47,05-03-2021
1000014096,4,791,815,24,05-04-2021
1000014097,1,0,287,287,05-01-2021
1000014097,2,0,287,287,05-02-2021
1000014097,3,0,287,287,05-03-2021
1000014097,4,0,287,287,05-04-2021
1000014097,5,0,287,287,05-05-2021
1000014097,6,0,287,287,05-06-2021
1000014097,7,1801,2088,287,05-07-2021
1000014097,8,1855,2088,233,05-08-2021
1000014097,9,1911,2088,177,05-09-2021
1000014097,10,1968,2088,120,05-10-2021
1000014097,11,2029,2090,61,05-11-2021
1000014098,1,996,1121,125,05-01-2021
1000014098,2,1026,1121,95,05-02-2021
1000014098,3,1057,1121,64,05-03-2021
1000014098,4,1086,1119,33,05-04-2021
1000014099,1,0,203,203,05-01-2021
1000014099,2,0,203,203,05-02-2021
1000014099,3,0,203,203,05-03-2021
1000014099,4,0,203,203,05-04-2021
1000014099,5,0,203,203,05-05-2021
1000014099,6,0,203,203,05-06-2021
1000014099,7,2190,2393,203,05-07-2021
1000014099,8,2256,2393,137,05-08-2021
1000014099,9,2323,2393,70,05-09-2021
1000014100,1,1721,2603,882,05-01-2021
1000014100,2,1772,2603,831,05-02-2021
1000014100,3,1826,2603,777,05-03-2021
1000014100,4,1880,2603,723,05-04-2021
1000014100,5,1937,2603,666,05-05-2021
1000014100,6,1995,2603,608,05-06-2021
1000014100,7,2055,2603,548,05-07-2021
1000014100,8,2116,2603,487,05-08-2021
1000014100,9,2180,2603,423,05-09-2021
1000014100,10,2245,2603,358,05-10-2021
1000014100,11,2313,2603,290,05-11-2021
1000014100,12,2382,2603,221,05-12-2021
1000014100,13,2453,2603,150,05-01-2022
1000014100,14,2534,2610,76,05-02-2022
1000014101,1,2370,3185,815,05-01-2021
1000014101,2,2441,3185,744,05-02-2021
1000014101,3,2514,3185,671,05-03-2021
1000014101,4,2590,3185,595,05-04-2021
1000014101,5,2667,3185,518,05-05-2021
1000014101,6,2747,3185,438,05-06-2021
1000014101,7,2830,3185,355,05-07-2021
1000014101,8,2915,3185,270,05-08-2021
1000014101,9,3002,3185,183,05-09-2021
1000014101,10,3095,3188,93,05-10-2021
1000014102,1,1946,2615,669,05-01-2021
1000014102,2,2004,2615,611,05-02-2021
1000014102,3,2064,2615,551,05-03-2021
1000014102,4,2126,2615,489,05-04-2021
1000014102,5,2190,2615,425,05-05-2021
1000014102,6,2256,2615,359,05-06-2021
1000014102,7,2323,2615,292,05-07-2021
1000014102,8,2393,2615,222,05-08-2021
1000014102,9,2465,2615,150,05-09-2021
1000014102,10,2536,2611,75,05-10-2021
1000014103,1,1164,1474,310,05-01-2021
1000014103,2,1199,1474,275,05-02-2021
1000014103,3,1235,1474,239,05-03-2021
1000014103,4,1272,1474,202,05-04-2021
1000014103,5,1310,1474,164,05-05-2021
1000014103,6,1349,1474,125,05-06-2021
1000014103,7,1390,1474,84,05-07-2021
1000014103,8,1426,1469,43,05-08-2021
1000014104,1,0,315,315,05-01-2021
1000014104,2,0,315,315,05-02-2021
1000014104,3,0,315,315,05-03-2021
1000014104,4,0,315,315,05-04-2021
1000014104,5,0,315,315,05-05-2021
1000014104,6,0,315,315,05-06-2021
1000014104,7,1975,2290,315,05-07-2021
1000014104,8,2035,2290,255,05-08-2021
1000014104,9,2096,2290,194,05-09-2021
1000014104,10,2159,2290,131,05-10-2021
1000014104,11,2221,2288,67,05-11-2021
1000014105,1,1012,1209,197,05-01-2021
1000014105,2,1043,1209,166,05-02-2021
1000014105,3,1074,1209,135,05-03-2021
1000014105,4,1106,1209,103,05-04-2021
1000014105,5,1139,1209,70,05-05-2021
1000014105,6,1178,1212,34,05-06-2021
1000014106,1,0,209,209,05-01-2021
1000014106,2,0,209,209,05-02-2021
1000014106,3,0,209,209,05-03-2021
1000014106,4,0,209,209,05-04-2021
1000014106,5,0,209,209,05-05-2021
1000014106,6,0,209,209,05-06-2021
1000014106,7,3426,3635,209,05-07-2021
1000014106,8,3529,3635,106,05-08-2021
1000014107,1,0,154,154,05-01-2021
1000014107,2,0,154,154,05-02-2021
1000014107,3,0,154,154,05-03-2021
1000014107,4,0,154,154,05-04-2021
1000014107,5,0,154,154,05-05-2021
1000014107,6,0,154,154,05-06-2021
1000014107,7,5139,5293,154,05-07-2021
1000014108,1,1417,2143,726,05-01-2021
1000014108,2,1459,2143,684,05-02-2021
1000014108,3,1503,2143,640,05-03-2021
1000014108,4,1548,2143,595,05-04-2021
1000014108,5,1595,2143,548,05-05-2021
1000014108,6,1643,2143,500,05-06-2021
1000014108,7,1692,2143,451,05-07-2021
1000014108,8,1743,2143,400,05-08-2021
1000014108,9,1795,2143,348,05-09-2021
1000014108,10,1849,2143,294,05-10-2021
1000014108,11,1904,2143,239,05-11-2021
1000014108,12,1961,2143,182,05-12-2021
1000014108,13,2020,2143,123,05-01-2022
1000014108,14,2075,2137,62,05-02-2022
1000014109,1,0,381,381,05-01-2021
1000014109,2,0,381,381,05-02-2021
1000014109,3,0,381,381,05-03-2021
1000014109,4,0,381,381,05-04-2021
1000014109,5,0,381,381,05-05-2021
1000014109,6,0,381,381,05-06-2021
1000014109,7,4109,4490,381,05-07-2021
1000014109,8,4232,4490,258,05-08-2021
1000014109,9,4359,4490,131,05-09-2021
1000014110,1,2148,2279,131,05-01-2021
1000014110,2,2212,2278,66,05-02-2021
1000014111,1,1012,1209,197,05-01-2021
1000014111,2,1043,1209,166,05-02-2021
1000014111,3,1074,1209,135,05-03-2021
1000014111,4,1106,1209,103,05-04-2021
1000014111,5,1139,1209,70,05-05-2021
1000014111,6,1178,1212,34,05-06-2021
1000014112,1,0,266,266,05-01-2021
1000014112,2,0,266,266,05-02-2021
1000014112,3,0,266,266,05-03-2021
1000014112,4,0,266,266,05-04-2021
1000014112,5,0,266,266,05-05-2021
1000014112,6,0,266,266,05-06-2021
1000014112,7,2118,2384,266,05-07-2021
1000014112,8,2182,2384,202,05-08-2021
1000014112,9,2247,2384,137,05-09-2021
1000014112,10,2313,2382,69,05-10-2021
1000014113,1,1790,2552,762,05-01-2021
1000014113,2,1844,2552,708,05-02-2021
1000014113,3,1899,2552,653,05-03-2021
1000014113,4,1956,2552,596,05-04-2021
1000014113,5,2015,2552,537,05-05-2021
1000014113,6,2075,2552,477,05-06-2021
1000014113,7,2137,2552,415,05-07-2021
1000014113,8,2201,2552,351,05-08-2021
1000014113,9,2268,2552,284,05-09-2021
1000014113,10,2336,2552,216,05-10-2021
1000014113,11,2406,2552,146,05-11-2021
1000014113,12,2473,2547,74,05-12-2021
1000014114,1,1912,2422,510,05-01-2021
1000014114,2,1969,2422,453,05-02-2021
1000014114,3,2028,2422,394,05-03-2021
1000014114,4,2089,2422,333,05-04-2021
1000014114,5,2152,2422,270,05-05-2021
1000014114,6,2216,2422,206,05-06-2021
1000014114,7,2283,2422,139,05-07-2021
1000014114,8,2353,2422,69,05-08-2021
1000014115,1,2198,2332,134,05-01-2021
1000014115,2,2264,2332,68,05-02-2021
1000014116,1,914,1229,315,05-01-2021
1000014116,2,942,1229,287,05-02-2021
1000014116,3,970,1229,259,05-03-2021
1000014116,4,999,1229,230,05-04-2021
1000014116,5,1029,1229,200,05-05-2021
1000014116,6,1060,1229,169,05-06-2021
1000014116,7,1092,1229,137,05-07-2021
1000014116,8,1125,1229,104,05-08-2021
1000014116,9,1158,1229,71,05-09-2021
1000014116,10,1197,1232,35,05-10-2021
1000014117,1,1203,1820,617,05-01-2021
1000014117,2,1239,1820,581,05-02-2021
1000014117,3,1276,1820,544,05-03-2021
1000014117,4,1315,1820,505,05-04-2021
1000014117,5,1354,1820,466,05-05-2021
1000014117,6,1395,1820,425,05-06-2021
1000014117,7,1437,1820,383,05-07-2021
1000014117,8,1480,1820,340,05-08-2021
1000014117,9,1524,1820,296,05-09-2021
1000014117,10,1570,1820,250,05-10-2021
1000014117,11,1617,1820,203,05-11-2021
1000014117,12,1665,1820,155,05-12-2021
1000014117,13,1715,1820,105,05-01-2022
1000014117,14,1773,1825,52,05-02-2022
1000014118,1,0,527,527,05-01-2021
1000014118,2,0,527,527,05-02-2021
1000014118,3,0,527,527,05-03-2021
1000014118,4,0,527,527,05-04-2021
1000014118,5,0,527,527,05-05-2021
1000014118,6,0,527,527,05-06-2021
1000014118,7,2715,3242,527,05-07-2021
1000014118,8,2796,3242,446,05-08-2021
1000014118,9,2880,3242,362,05-09-2021
1000014118,10,2967,3242,275,05-10-2021
1000014118,11,3056,3242,186,05-11-2021
1000014118,12,3151,3245,94,05-12-2021
1000014119,1,2532,2686,154,05-01-2021
1000014119,2,2607,2685,78,05-02-2021
1000014120,1,836,1124,288,05-01-2021
1000014120,2,861,1124,263,05-02-2021
1000014120,3,887,1124,237,05-03-2021
1000014120,4,914,1124,210,05-04-2021
1000014120,5,941,1124,183,05-05-2021
1000014120,6,970,1124,154,05-06-2021
1000014120,7,999,1124,125,05-07-2021
1000014120,8,1029,1124,95,05-08-2021
1000014120,9,1059,1124,65,05-09-2021
1000014120,10,1091,1123,32,05-10-2021
1000014121,1,1428,1809,381,05-01-2021
1000014121,2,1471,1809,338,05-02-2021
1000014121,3,1515,1809,294,05-03-2021
1000014121,4,1560,1809,249,05-04-2021
1000014121,5,1607,1809,202,05-05-2021
1000014121,6,1655,1809,154,05-06-2021
1000014121,7,1705,1809,104,05-07-2021
1000014121,8,1759,1811,52,05-08-2021
1000014122,1,1689,2555,866,05-01-2021
1000014122,2,1740,2555,815,05-02-2021
1000014122,3,1792,2555,763,05-03-2021
1000014122,4,1846,2555,709,05-04-2021
1000014122,5,1901,2555,654,05-05-2021
1000014122,6,1958,2555,597,05-06-2021
1000014122,7,2017,2555,538,05-07-2021
1000014122,8,2077,2555,478,05-08-2021
1000014122,9,2140,2555,415,05-09-2021
1000014122,10,2204,2555,351,05-10-2021
1000014122,11,2270,2555,285,05-11-2021
1000014122,12,2338,2555,217,05-12-2021
1000014122,13,2408,2555,147,05-01-2022
1000014122,14,2480,2553,73,05-02-2022
1000014123,1,0,338,338,05-01-2021
1000014123,2,0,338,338,05-02-2021
1000014123,3,0,338,338,05-03-2021
1000014123,4,0,338,338,05-04-2021
1000014123,5,0,338,338,05-05-2021
1000014123,6,0,338,338,05-06-2021
1000014123,7,2694,3032,338,05-07-2021
1000014123,8,2775,3032,257,05-08-2021
1000014123,9,2858,3032,174,05-09-2021
1000014123,10,2945,3033,88,05-10-2021
1000014124,1,0,735,735,05-01-2021
1000014124,2,0,735,735,05-02-2021
1000014124,3,0,735,735,05-03-2021
1000014124,4,0,735,735,05-04-2021
1000014124,5,0,735,735,05-05-2021
1000014124,6,0,735,735,05-06-2021
1000014124,7,3789,4524,735,05-07-2021
1000014124,8,3903,4524,621,05-08-2021
1000014124,9,4020,4524,504,05-09-2021
1000014124,10,4140,4524,384,05-10-2021
1000014124,11,4264,4524,260,05-11-2021
1000014124,12,4389,4521,132,05-12-2021
1000014125,1,895,1276,381,05-01-2021
1000014125,2,922,1276,354,05-02-2021
1000014125,3,950,1276,326,05-03-2021
1000014125,4,978,1276,298,05-04-2021
1000014125,5,1007,1276,269,05-05-2021
1000014125,6,1038,1276,238,05-06-2021
1000014125,7,1069,1276,207,05-07-2021
1000014125,8,1101,1276,175,05-08-2021
1000014125,9,1134,1276,142,05-09-2021
1000014125,10,1168,1276,108,05-10-2021
1000014125,11,1203,1276,73,05-11-2021
1000014125,12,1235,1272,37,05-12-2021
1000014126,1,0,560,560,05-01-2021
1000014126,2,0,560,560,05-02-2021
1000014126,3,0,560,560,05-03-2021
1000014126,4,0,560,560,05-04-2021
1000014126,5,0,560,560,05-05-2021
1000014126,6,0,560,560,05-06-2021
1000014126,7,3517,4077,560,05-07-2021
1000014126,8,3622,4077,455,05-08-2021
1000014126,9,3731,4077,346,05-09-2021
1000014126,10,3843,4077,234,05-10-2021
1000014126,11,3958,4077,119,05-11-2021
1000014127,1,0,526,526,05-01-2021
1000014127,2,1552,2086,534,05-02-2021
1000014127,3,1599,2086,487,05-03-2021
1000014127,4,1647,2086,439,05-04-2021
1000014127,5,1696,2086,390,05-05-2021
1000014127,6,1747,2086,339,05-06-2021
1000014127,7,1799,2086,287,05-07-2021
1000014127,8,1853,2086,233,05-08-2021
1000014127,9,1909,2086,177,05-09-2021
1000014127,10,1966,2086,120,05-10-2021
1000014127,11,2023,2083,60,05-11-2021
1000014128,1,1207,1359,152,05-01-2021
1000014128,2,1244,1359,115,05-02-2021
1000014128,3,1281,1359,78,05-03-2021
1000014128,4,1319,1358,39,05-04-2021
1000014129,1,1085,1847,762,05-01-2021
1000014129,2,1118,1847,729,05-02-2021
1000014129,3,1151,1847,696,05-03-2021
1000014129,4,1186,1847,661,05-04-2021
1000014129,5,1221,1847,626,05-05-2021
1000014129,6,1258,1847,589,05-06-2021
1000014129,7,1296,1847,551,05-07-2021
1000014129,8,1334,1847,513,05-08-2021
1000014129,9,1374,1847,473,05-09-2021
1000014129,10,1416,1847,431,05-10-2021
1000014129,11,1458,1847,389,05-11-2021
1000014129,12,1502,1847,345,05-12-2021
1000014129,13,1547,1847,300,05-01-2022
1000014129,14,1593,1847,254,05-02-2022
1000014129,15,1641,1847,206,05-03-2022
1000014129,16,1690,1847,157,05-04-2022
1000014129,17,1741,1847,106,05-05-2022
1000014129,18,1789,1843,54,05-06-2022
1000014130,1,0,381,381,05-01-2021
1000014130,2,0,381,381,05-02-2021
1000014130,3,0,381,381,05-03-2021
1000014130,4,0,381,381,05-04-2021
1000014130,5,0,381,381,05-05-2021
1000014130,6,0,381,381,05-06-2021
1000014130,7,1963,2344,381,05-07-2021
1000014130,8,2022,2344,322,05-08-2021
1000014130,9,2083,2344,261,05-09-2021
1000014130,10,2145,2344,199,05-10-2021
1000014130,11,2209,2344,135,05-11-2021
1000014130,12,2278,2346,68,05-12-2021
1000014131,1,1824,2600,776,05-01-2021
1000014131,2,1878,2600,722,05-02-2021
1000014131,3,1935,2600,665,05-03-2021
1000014131,4,1993,2600,607,05-04-2021
1000014131,5,2052,2600,548,05-05-2021
1000014131,6,2114,2600,486,05-06-2021
1000014131,7,2177,2600,423,05-07-2021
1000014131,8,2243,2600,357,05-08-2021
1000014131,9,2310,2600,290,05-09-2021
1000014131,10,2379,2600,221,05-10-2021
1000014131,11,2451,2600,149,05-11-2021
1000014131,12,2524,2600,76,05-12-2021
1000014132,1,937,1259,322,05-01-2021
1000014132,2,965,1259,294,05-02-2021
1000014132,3,994,1259,265,05-03-2021
1000014132,4,1024,1259,235,05-04-2021
1000014132,5,1054,1259,205,05-05-2021
1000014132,6,1086,1259,173,05-06-2021
1000014132,7,1119,1259,140,05-07-2021
1000014132,8,1152,1259,107,05-08-2021
1000014132,9,1187,1259,72,05-09-2021
1000014132,10,1222,1259,37,05-10-2021
1000014133,1,1873,2517,644,05-01-2021
1000014133,2,1929,2517,588,05-02-2021
1000014133,3,1987,2517,530,05-03-2021
1000014133,4,2047,2517,470,05-04-2021
1000014133,5,2108,2517,409,05-05-2021
1000014133,6,2171,2517,346,05-06-2021
1000014133,7,2236,2517,281,05-07-2021
1000014133,8,2303,2517,214,05-08-2021
1000014133,9,2372,2517,145,05-09-2021
1000014133,10,2445,2518,73,05-10-2021
1000014134,1,0,247,247,05-01-2021
1000014134,2,0,247,247,05-02-2021
1000014134,3,0,247,247,05-03-2021
1000014134,4,0,247,247,05-04-2021
1000014134,5,0,247,247,05-05-2021
1000014134,6,0,247,247,05-06-2021
1000014134,7,1970,2217,247,05-07-2021
1000014134,8,2029,2217,188,05-08-2021
1000014134,9,2090,2217,127,05-09-2021
1000014134,10,2153,2218,65,05-10-2021
1000014135,1,1057,1697,640,05-01-2021
1000014135,2,1089,1697,608,05-02-2021
1000014135,3,1122,1697,575,05-03-2021
1000014135,4,1155,1697,542,05-04-2021
1000014135,5,1190,1697,507,05-05-2021
1000014135,6,1226,1697,471,05-06-2021
1000014135,7,1263,1697,434,05-07-2021
1000014135,8,1300,1697,397,05-08-2021
1000014135,9,1339,1697,358,05-09-2021
1000014135,10,1380,1697,317,05-10-2021
1000014135,11,1421,1697,276,05-11-2021
1000014135,12,1464,1697,233,05-12-2021
1000014135,13,1508,1697,189,05-01-2022
1000014135,14,1553,1697,144,05-02-2022
1000014135,15,1599,1697,98,05-03-2022
1000014135,16,1653,1701,48,05-04-2022
1000014136,1,1856,2647,791,05-01-2021
1000014136,2,1912,2647,735,05-02-2021
1000014136,3,1970,2647,677,05-03-2021
1000014136,4,2029,2647,618,05-04-2021
1000014136,5,2090,2647,557,05-05-2021
1000014136,6,2152,2647,495,05-06-2021
1000014136,7,2217,2647,430,05-07-2021
1000014136,8,2283,2647,364,05-08-2021
1000014136,9,2352,2647,295,05-09-2021
1000014136,10,2422,2647,225,05-10-2021
1000014136,11,2495,2647,152,05-11-2021
1000014136,12,2572,2649,77,05-12-2021
1000014137,1,1800,2566,766,05-01-2021
1000014137,2,1854,2566,712,05-02-2021
1000014137,3,1909,2566,657,05-03-2021
1000014137,4,1967,2566,599,05-04-2021
1000014137,5,2026,2566,540,05-05-2021
1000014137,6,2086,2566,480,05-06-2021
1000014137,7,2149,2566,417,05-07-2021
1000014137,8,2213,2566,353,05-08-2021
1000014137,9,2280,2566,286,05-09-2021
1000014137,10,2348,2566,218,05-10-2021
1000014137,11,2419,2566,147,05-11-2021
1000014137,12,2495,2570,75,05-12-2021
1000014138,1,1189,1799,610,05-01-2021
1000014138,2,1225,1799,574,05-02-2021
1000014138,3,1262,1799,537,05-03-2021
1000014138,4,1300,1799,499,05-04-2021
1000014138,5,1339,1799,460,05-05-2021
1000014138,6,1379,1799,420,05-06-2021
1000014138,7,1420,1799,379,05-07-2021
1000014138,8,1463,1799,336,05-08-2021
1000014138,9,1507,1799,292,05-09-2021
1000014138,10,1552,1799,247,05-10-2021
1000014138,11,1598,1799,201,05-11-2021
1000014138,12,1646,1799,153,05-12-2021
1000014138,13,1696,1799,103,05-01-2022
1000014138,14,1747,1799,52,05-02-2022
1000014139,1,2444,3284,840,05-01-2021
1000014139,2,2517,3284,767,05-02-2021
1000014139,3,2592,3284,692,05-03-2021
1000014139,4,2670,3284,614,05-04-2021
1000014139,5,2750,3284,534,05-05-2021
1000014139,6,2833,3284,451,05-06-2021
1000014139,7,2918,3284,366,05-07-2021
1000014139,8,3005,3284,279,05-08-2021
1000014139,9,3096,3284,188,05-09-2021
1000014139,10,3186,3281,95,05-10-2021
1000014140,1,0,953,953,05-01-2021
1000014140,2,0,953,953,05-02-2021
1000014140,3,0,953,953,05-03-2021
1000014140,4,0,953,953,05-04-2021
1000014140,5,0,953,953,05-05-2021
1000014140,6,0,953,953,05-06-2021
1000014140,7,3125,4078,953,05-07-2021
1000014140,8,3219,4078,859,05-08-2021
1000014140,9,3316,4078,762,05-09-2021
1000014140,10,3415,4078,663,05-10-2021
1000014140,11,3518,4078,560,05-11-2021
1000014140,12,3623,4078,455,05-12-2021
1000014140,13,3732,4078,346,05-01-2022
1000014140,14,3844,4078,234,05-02-2022
1000014140,15,3958,4076,118,05-03-2022
1000014141,1,3059,3653,594,05-01-2021
1000014141,2,3151,3653,502,05-02-2021
1000014141,3,3246,3653,407,05-03-2021
1000014141,4,3343,3653,310,05-04-2021
1000014141,5,3443,3653,210,05-05-2021
1000014141,6,3547,3653,106,05-06-2021
1000014142,1,0,211,211,05-01-2021
1000014142,2,0,211,211,05-02-2021
1000014142,3,0,211,211,05-03-2021
1000014142,4,0,211,211,05-04-2021
1000014142,5,0,211,211,05-05-2021
1000014142,6,0,211,211,05-06-2021
1000014142,7,7030,7241,211,05-07-2021
1000014143,1,2343,2486,143,05-01-2021
1000014143,2,2414,2486,72,05-02-2021
1000014144,1,0,780,780,05-01-2021
1000014144,2,0,780,780,05-02-2021
1000014144,3,0,780,780,05-03-2021
1000014144,4,0,780,780,05-04-2021
1000014144,5,0,780,780,05-05-2021
1000014144,6,0,780,780,05-06-2021
1000014144,7,6215,6995,780,05-07-2021
1000014144,8,6401,6995,594,05-08-2021
1000014144,9,6593,6995,402,05-09-2021
1000014144,10,6791,6994,203,05-10-2021
1000014145,1,1022,1150,128,05-01-2021
1000014145,2,1052,1150,98,05-02-2021
1000014145,3,1084,1150,66,05-03-2021
1000014145,4,1117,1150,33,05-04-2021
1000014146,1,959,1289,330,05-01-2021
1000014146,2,988,1289,301,05-02-2021
1000014146,3,1018,1289,271,05-03-2021
1000014146,4,1048,1289,241,05-04-2021
1000014146,5,1080,1289,209,05-05-2021
1000014146,6,1112,1289,177,05-06-2021
1000014146,7,1145,1289,144,05-07-2021
1000014146,8,1180,1289,109,05-08-2021
1000014146,9,1215,1289,74,05-09-2021
1000014146,10,1249,1286,37,05-10-2021
1000014147,1,0,367,367,05-01-2021
1000014147,2,0,367,367,05-02-2021
1000014147,3,0,367,367,05-03-2021
1000014147,4,0,367,367,05-04-2021
1000014147,5,0,367,367,05-05-2021
1000014147,6,0,367,367,05-06-2021
1000014147,7,1892,2259,367,05-07-2021
1000014147,8,1949,2259,310,05-08-2021
1000014147,9,2007,2259,252,05-09-2021
1000014147,10,2067,2259,192,05-10-2021
1000014147,11,2129,2259,130,05-11-2021
1000014147,12,2195,2261,66,05-12-2021
1000014148,1,3019,3398,379,05-01-2021
1000014148,2,3110,3398,288,05-02-2021
1000014148,3,3203,3398,195,05-03-2021
1000014148,4,3298,3397,99,05-04-2021
1000014149,1,0,381,381,05-01-2021
1000014149,2,0,381,381,05-02-2021
1000014149,3,0,381,381,05-03-2021
1000014149,4,0,381,381,05-04-2021
1000014149,5,0,381,381,05-05-2021
1000014149,6,0,381,381,05-06-2021
1000014149,7,1963,2344,381,05-07-2021
1000014149,8,2022,2344,322,05-08-2021
1000014149,9,2083,2344,261,05-09-2021
1000014149,10,2145,2344,199,05-10-2021
1000014149,11,2209,2344,135,05-11-2021
1000014149,12,2278,2346,68,05-12-2021
1000014150,1,0,762,762,05-01-2021
1000014150,2,0,762,762,05-02-2021
1000014150,3,0,762,762,05-03-2021
1000014150,4,0,762,762,05-04-2021
1000014150,5,0,762,762,05-05-2021
1000014150,6,0,762,762,05-06-2021
1000014150,7,2500,3262,762,05-07-2021
1000014150,8,2575,3262,687,05-08-2021
1000014150,9,2652,3262,610,05-09-2021
1000014150,10,2732,3262,530,05-10-2021
1000014150,11,2814,3262,448,05-11-2021
1000014150,12,2898,3262,364,05-12-2021
1000014150,13,2985,3262,277,05-01-2022
1000014150,14,3075,3262,187,05-02-2022
1000014150,15,3169,3264,95,05-03-2022
1000014151,1,0,337,337,05-01-2021
1000014151,2,0,337,337,05-02-2021
1000014151,3,0,337,337,05-03-2021
1000014151,4,0,337,337,05-04-2021
1000014151,5,0,337,337,05-05-2021
1000014151,6,0,337,337,05-06-2021
1000014151,7,2119,2456,337,05-07-2021
1000014151,8,2182,2456,274,05-08-2021
1000014151,9,2248,2456,208,05-09-2021
1000014151,10,2315,2456,141,05-10-2021
1000014151,11,2384,2456,72,05-11-2021
1000014152,1,1242,1669,427,05-01-2021
1000014152,2,1279,1669,390,05-02-2021
1000014152,3,1318,1669,351,05-03-2021
1000014152,4,1357,1669,312,05-04-2021
1000014152,5,1398,1669,271,05-05-2021
1000014152,6,1440,1669,229,05-06-2021
1000014152,7,1483,1669,186,05-07-2021
1000014152,8,1528,1669,141,05-08-2021
1000014152,9,1573,1669,96,05-09-2021
1000014152,10,1615,1663,48,05-10-2021
1000014153,1,0,321,321,05-01-2021
1000014153,2,0,321,321,05-02-2021
1000014153,3,0,321,321,05-03-2021
1000014153,4,0,321,321,05-04-2021
1000014153,5,0,321,321,05-05-2021
1000014153,6,0,321,321,05-06-2021
1000014153,7,2019,2340,321,05-07-2021
1000014153,8,2079,2340,261,05-08-2021
1000014153,9,2141,2340,199,05-09-2021
1000014153,10,2206,2340,134,05-10-2021
1000014153,11,2271,2339,68,05-11-2021
1000014154,1,2151,2421,270,05-01-2021
1000014154,2,2216,2421,205,05-02-2021
1000014154,3,2282,2421,139,05-03-2021
1000014154,4,2349,2419,70,05-04-2021
1000014155,1,0,270,270,05-01-2021
1000014155,2,0,270,270,05-02-2021
1000014155,3,0,270,270,05-03-2021
1000014155,4,0,270,270,05-04-2021
1000014155,5,0,270,270,05-05-2021
1000014155,6,0,270,270,05-06-2021
1000014155,7,4432,4702,270,05-07-2021
1000014155,8,4566,4703,137,05-08-2021
1000014156,1,1704,2734,1030,05-01-2021
1000014156,2,1755,2734,979,05-02-2021
1000014156,3,1807,2734,927,05-03-2021
1000014156,4,1862,2734,872,05-04-2021
1000014156,5,1917,2734,817,05-05-2021
1000014156,6,1975,2734,759,05-06-2021
1000014156,7,2034,2734,700,05-07-2021
1000014156,8,2095,2734,639,05-08-2021
1000014156,9,2158,2734,576,05-09-2021
1000014156,10,2223,2734,511,05-10-2021
1000014156,11,2290,2734,444,05-11-2021
1000014156,12,2358,2734,376,05-12-2021
1000014156,13,2429,2734,305,05-01-2022
1000014156,14,2502,2734,232,05-02-2022
1000014156,15,2577,2734,157,05-03-2022
1000014156,16,2660,2739,79,05-04-2022
1000014157,1,0,131,131,05-01-2021
1000014157,2,0,131,131,05-02-2021
1000014157,3,0,131,131,05-03-2021
1000014157,4,0,131,131,05-04-2021
1000014157,5,0,131,131,05-05-2021
1000014157,6,0,131,131,05-06-2021
1000014157,7,4360,4491,131,05-07-2021
1000014158,1,0,154,154,05-01-2021
1000014158,2,0,154,154,05-02-2021
1000014158,3,0,154,154,05-03-2021
1000014158,4,0,154,154,05-04-2021
1000014158,5,0,154,154,05-05-2021
1000014158,6,0,154,154,05-06-2021
1000014158,7,5139,5293,154,05-07-2021
1000014159,1,0,11,11,05-01-2021
1000014159,2,0,11,11,05-02-2021
1000014159,3,0,11,11,05-03-2021
1000014159,4,0,11,11,05-04-2021
1000014159,5,0,11,11,05-05-2021
1000014159,6,0,11,11,05-06-2021
1000014159,7,352,363,11,05-07-2021
1000014160,1,957,1212,255,05-01-2021
1000014160,2,985,1212,227,05-02-2021
1000014160,3,1015,1212,197,05-03-2021
1000014160,4,1045,1212,167,05-04-2021
1000014160,5,1077,1212,135,05-05-2021
1000014160,6,1109,1212,103,05-06-2021
1000014160,7,1142,1212,70,05-07-2021
1000014160,8,1180,1214,34,05-08-2021
1000014161,1,0,308,308,05-01-2021
1000014161,2,0,308,308,05-02-2021
1000014161,3,0,308,308,05-03-2021
1000014161,4,0,308,308,05-04-2021
1000014161,5,0,308,308,05-05-2021
1000014161,6,0,308,308,05-06-2021
1000014161,7,1936,2244,308,05-07-2021
1000014161,8,1994,2244,250,05-08-2021
1000014161,9,2054,2244,190,05-09-2021
1000014161,10,2115,2244,129,05-10-2021
1000014161,11,2179,2244,65,05-11-2021
1000014162,1,934,1183,249,05-01-2021
1000014162,2,962,1183,221,05-02-2021
1000014162,3,991,1183,192,05-03-2021
1000014162,4,1020,1183,163,05-04-2021
1000014162,5,1051,1183,132,05-05-2021
1000014162,6,1083,1183,100,05-06-2021
1000014162,7,1115,1183,68,05-07-2021
1000014162,8,1148,1182,34,05-08-2021
1000014163,1,1966,2490,524,05-01-2021
1000014163,2,2025,2490,465,05-02-2021
1000014163,3,2085,2490,405,05-03-2021
1000014163,4,2148,2490,342,05-04-2021
1000014163,5,2212,2490,278,05-05-2021
1000014163,6,2279,2490,211,05-06-2021
1000014163,7,2347,2490,143,05-07-2021
1000014163,8,2419,2492,73,05-08-2021
1000014164,1,1189,1799,610,05-01-2021
1000014164,2,1225,1799,574,05-02-2021
1000014164,3,1262,1799,537,05-03-2021
1000014164,4,1300,1799,499,05-04-2021
1000014164,5,1339,1799,460,05-05-2021
1000014164,6,1379,1799,420,05-06-2021
1000014164,7,1420,1799,379,05-07-2021
1000014164,8,1463,1799,336,05-08-2021
1000014164,9,1507,1799,292,05-09-2021
1000014164,10,1552,1799,247,05-10-2021
1000014164,11,1598,1799,201,05-11-2021
1000014164,12,1646,1799,153,05-12-2021
1000014164,13,1696,1799,103,05-01-2022
1000014164,14,1747,1799,52,05-02-2022
1000014165,1,1798,2417,619,05-01-2021
1000014165,2,1852,2417,565,05-02-2021
1000014165,3,1908,2417,509,05-03-2021
1000014165,4,1965,2417,452,05-04-2021
1000014165,5,2024,2417,393,05-05-2021
1000014165,6,2085,2417,332,05-06-2021
1000014165,7,2147,2417,270,05-07-2021
1000014165,8,2212,2417,205,05-08-2021
1000014165,9,2278,2417,139,05-09-2021
1000014165,10,2349,2418,69,05-10-2021
1000014166,1,841,1199,358,05-01-2021
1000014166,2,866,1199,333,05-02-2021
1000014166,3,892,1199,307,05-03-2021
1000014166,4,919,1199,280,05-04-2021
1000014166,5,946,1199,253,05-05-2021
1000014166,6,975,1199,224,05-06-2021
1000014166,7,1004,1199,195,05-07-2021
1000014166,8,1034,1199,165,05-08-2021
1000014166,9,1065,1199,134,05-09-2021
1000014166,10,1097,1199,102,05-10-2021
1000014166,11,1130,1199,69,05-11-2021
1000014166,12,1170,1204,34,05-12-2021
1000014167,1,1052,1256,204,05-01-2021
1000014167,2,1083,1256,173,05-02-2021
1000014167,3,1116,1256,140,05-03-2021
1000014167,4,1149,1256,107,05-04-2021
1000014167,5,1184,1256,72,05-05-2021
1000014167,6,1222,1258,36,05-06-2021
1000014168,1,0,890,890,05-01-2021
1000014168,2,2623,3525,902,05-02-2021
1000014168,3,2702,3525,823,05-03-2021
1000014168,4,2783,3525,742,05-04-2021
1000014168,5,2866,3525,659,05-05-2021
1000014168,6,2952,3525,573,05-06-2021
1000014168,7,3041,3525,484,05-07-2021
1000014168,8,3132,3525,393,05-08-2021
1000014168,9,3226,3525,299,05-09-2021
1000014168,10,3323,3525,202,05-10-2021
1000014168,11,3418,3521,103,05-11-2021
1000014169,1,0,199,199,05-01-2021
1000014169,2,0,199,199,05-02-2021
1000014169,3,0,199,199,05-03-2021
1000014169,4,0,199,199,05-04-2021
1000014169,5,0,199,199,05-05-2021
1000014169,6,0,199,199,05-06-2021
1000014169,7,2147,2346,199,05-07-2021
1000014169,8,2211,2346,135,05-08-2021
1000014169,9,2277,2345,68,05-09-2021
1000014170,1,1837,2193,356,05-01-2021
1000014170,2,1892,2193,301,05-02-2021
1000014170,3,1948,2193,245,05-03-2021
1000014170,4,2007,2193,186,05-04-2021
1000014170,5,2067,2193,126,05-05-2021
1000014170,6,2128,2192,64,05-06-2021
1000014171,1,0,261,261,05-01-2021
1000014171,2,0,261,261,05-02-2021
1000014171,3,0,261,261,05-03-2021
1000014171,4,0,261,261,05-04-2021
1000014171,5,0,261,261,05-05-2021
1000014171,6,0,261,261,05-06-2021
1000014171,7,2084,2345,261,05-07-2021
1000014171,8,2146,2345,199,05-08-2021
1000014171,9,2210,2345,135,05-09-2021
1000014171,10,2276,2344,68,05-10-2021
1000014172,1,1755,2503,748,05-01-2021
1000014172,2,1808,2503,695,05-02-2021
1000014172,3,1862,2503,641,05-03-2021
1000014172,4,1918,2503,585,05-04-2021
1000014172,5,1976,2503,527,05-05-2021
1000014172,6,2035,2503,468,05-06-2021
1000014172,7,2096,2503,407,05-07-2021
1000014172,8,2159,2503,344,05-08-2021
1000014172,9,2224,2503,279,05-09-2021
1000014172,10,2290,2503,213,05-10-2021
1000014172,11,2359,2503,144,05-11-2021
1000014172,12,2435,2506,71,05-12-2021
1000014173,1,1347,1429,82,05-01-2021
1000014173,2,1388,1430,42,05-02-2021
1000014174,1,1848,2341,493,05-01-2021
1000014174,2,1903,2341,438,05-02-2021
1000014174,3,1961,2341,380,05-03-2021
1000014174,4,2019,2341,322,05-04-2021
1000014174,5,2080,2341,261,05-05-2021
1000014174,6,2142,2341,199,05-06-2021
1000014174,7,2207,2341,134,05-07-2021
1000014174,8,2273,2341,68,05-08-2021
1000014175,1,0,1143,1143,05-01-2021
1000014175,2,0,1143,1143,05-02-2021
1000014175,3,0,1143,1143,05-03-2021
1000014175,4,0,1143,1143,05-04-2021
1000014175,5,0,1143,1143,05-05-2021
1000014175,6,0,1143,1143,05-06-2021
1000014175,7,3750,4893,1143,05-07-2021
1000014175,8,3862,4893,1031,05-08-2021
1000014175,9,3978,4893,915,05-09-2021
1000014175,10,4098,4893,795,05-10-2021
1000014175,11,4221,4893,672,05-11-2021
1000014175,12,4347,4893,546,05-12-2021
1000014175,13,4478,4893,415,05-01-2022
1000014175,14,4612,4893,281,05-02-2022
1000014175,15,4754,4896,142,05-03-2022
1000014176,1,0,390,390,05-01-2021
1000014176,2,0,390,390,05-02-2021
1000014176,3,0,390,390,05-03-2021
1000014176,4,0,390,390,05-04-2021
1000014176,5,0,390,390,05-05-2021
1000014176,6,0,390,390,05-06-2021
1000014176,7,2010,2400,390,05-07-2021
1000014176,8,2070,2400,330,05-08-2021
1000014176,9,2132,2400,268,05-09-2021
1000014176,10,2196,2400,204,05-10-2021
1000014176,11,2262,2400,138,05-11-2021
1000014176,12,2330,2399,69,05-12-2021
1000014177,1,0,52,52,05-01-2021
1000014177,2,0,52,52,05-02-2021
1000014177,3,0,52,52,05-03-2021
1000014177,4,0,52,52,05-04-2021
1000014177,5,0,52,52,05-05-2021
1000014177,6,0,52,52,05-06-2021
1000014177,7,1740,1792,52,05-07-2021
1000014178,1,0,191,191,05-01-2021
1000014178,2,0,191,191,05-02-2021
1000014178,3,0,191,191,05-03-2021
1000014178,4,0,191,191,05-04-2021
1000014178,5,0,191,191,05-05-2021
1000014178,6,0,191,191,05-06-2021
1000014178,7,3139,3330,191,05-07-2021
1000014178,8,3233,3330,97,05-08-2021
1000014179,1,1294,1373,79,05-01-2021
1000014179,2,1333,1373,40,05-02-2021
1000014180,1,1420,2279,859,05-01-2021
1000014180,2,1463,2279,816,05-02-2021
1000014180,3,1507,2279,772,05-03-2021
1000014180,4,1552,2279,727,05-04-2021
1000014180,5,1599,2279,680,05-05-2021
1000014180,6,1647,2279,632,05-06-2021
1000014180,7,1696,2279,583,05-07-2021
1000014180,8,1747,2279,532,05-08-2021
1000014180,9,1799,2279,480,05-09-2021
1000014180,10,1853,2279,426,05-10-2021
1000014180,11,1909,2279,370,05-11-2021
1000014180,12,1966,2279,313,05-12-2021
1000014180,13,2025,2279,254,05-01-2022
1000014180,14,2086,2279,193,05-02-2022
1000014180,15,2148,2279,131,05-03-2022
1000014180,16,2206,2272,66,05-04-2022
1000014181,1,1790,2552,762,05-01-2021
1000014181,2,1844,2552,708,05-02-2021
1000014181,3,1899,2552,653,05-03-2021
1000014181,4,1956,2552,596,05-04-2021
1000014181,5,2015,2552,537,05-05-2021
1000014181,6,2075,2552,477,05-06-2021
1000014181,7,2137,2552,415,05-07-2021
1000014181,8,2201,2552,351,05-08-2021
1000014181,9,2268,2552,284,05-09-2021
1000014181,10,2336,2552,216,05-10-2021
1000014181,11,2406,2552,146,05-11-2021
1000014181,12,2473,2547,74,05-12-2021
1000014182,1,1493,1891,398,05-01-2021
1000014182,2,1538,1891,353,05-02-2021
1000014182,3,1584,1891,307,05-03-2021
1000014182,4,1631,1891,260,05-04-2021
1000014182,5,1680,1891,211,05-05-2021
1000014182,6,1731,1891,160,05-06-2021
1000014182,7,1783,1891,108,05-07-2021
1000014182,8,1833,1888,55,05-08-2021
1000014183,1,0,199,199,05-01-2021
1000014183,2,0,199,199,05-02-2021
1000014183,3,0,199,199,05-03-2021
1000014183,4,0,199,199,05-04-2021
1000014183,5,0,199,199,05-05-2021
1000014183,6,0,199,199,05-06-2021
1000014183,7,2147,2346,199,05-07-2021
1000014183,8,2211,2346,135,05-08-2021
1000014183,9,2277,2345,68,05-09-2021
1000014184,1,1845,2630,785,05-01-2021
1000014184,2,1900,2630,730,05-02-2021
1000014184,3,1957,2630,673,05-03-2021
1000014184,4,2016,2630,614,05-04-2021
1000014184,5,2076,2630,554,05-05-2021
1000014184,6,2138,2630,492,05-06-2021
1000014184,7,2203,2630,427,05-07-2021
1000014184,8,2269,2630,361,05-08-2021
1000014184,9,2337,2630,293,05-09-2021
1000014184,10,2407,2630,223,05-10-2021
1000014184,11,2479,2630,151,05-11-2021
1000014184,12,2552,2629,77,05-12-2021
1000014185,1,0,247,247,05-01-2021
1000014185,2,0,247,247,05-02-2021
1000014185,3,0,247,247,05-03-2021
1000014185,4,0,247,247,05-04-2021
1000014185,5,0,247,247,05-05-2021
1000014185,6,0,247,247,05-06-2021
1000014185,7,4053,4300,247,05-07-2021
1000014185,8,4174,4299,125,05-08-2021
1000014186,1,0,898,898,05-01-2021
1000014186,2,0,898,898,05-02-2021
1000014186,3,0,898,898,05-03-2021
1000014186,4,0,898,898,05-04-2021
1000014186,5,0,898,898,05-05-2021
1000014186,6,0,898,898,05-06-2021
1000014186,7,3908,4806,898,05-07-2021
1000014186,8,4025,4806,781,05-08-2021
1000014186,9,4146,4806,660,05-09-2021
1000014186,10,4270,4806,536,05-10-2021
1000014186,11,4398,4806,408,05-11-2021
1000014186,12,4530,4806,276,05-12-2021
1000014186,13,4668,4808,140,05-01-2022
1000014187,1,0,190,190,05-01-2021
1000014187,2,0,190,190,05-02-2021
1000014187,3,0,190,190,05-03-2021
1000014187,4,0,190,190,05-04-2021
1000014187,5,0,190,190,05-05-2021
1000014187,6,0,190,190,05-06-2021
1000014187,7,2053,2243,190,05-07-2021
1000014187,8,2114,2243,129,05-08-2021
1000014187,9,2177,2242,65,05-09-2021
1000014188,1,1837,2619,782,05-01-2021
1000014188,2,1892,2619,727,05-02-2021
1000014188,3,1949,2619,670,05-03-2021
1000014188,4,2007,2619,612,05-04-2021
1000014188,5,2068,2619,551,05-05-2021
1000014188,6,2130,2619,489,05-06-2021
1000014188,7,2193,2619,426,05-07-2021
1000014188,8,2259,2619,360,05-08-2021
1000014188,9,2327,2619,292,05-09-2021
1000014188,10,2397,2619,222,05-10-2021
1000014188,11,2469,2619,150,05-11-2021
1000014188,12,2540,2616,76,05-12-2021
1000014189,1,1022,1150,128,05-01-2021
1000014189,2,1052,1150,98,05-02-2021
1000014189,3,1084,1150,66,05-03-2021
1000014189,4,1117,1150,33,05-04-2021
1000014190,1,895,1276,381,05-01-2021
1000014190,2,922,1276,354,05-02-2021
1000014190,3,950,1276,326,05-03-2021
1000014190,4,978,1276,298,05-04-2021
1000014190,5,1007,1276,269,05-05-2021
1000014190,6,1038,1276,238,05-06-2021
1000014190,7,1069,1276,207,05-07-2021
1000014190,8,1101,1276,175,05-08-2021
1000014190,9,1134,1276,142,05-09-2021
1000014190,10,1168,1276,108,05-10-2021
1000014190,11,1203,1276,73,05-11-2021
1000014190,12,1235,1272,37,05-12-2021
1000014191,1,1096,1562,466,05-01-2021
1000014191,2,1128,1562,434,05-02-2021
1000014191,3,1162,1562,400,05-03-2021
1000014191,4,1197,1562,365,05-04-2021
1000014191,5,1233,1562,329,05-05-2021
1000014191,6,1270,1562,292,05-06-2021
1000014191,7,1308,1562,254,05-07-2021
1000014191,8,1347,1562,215,05-08-2021
1000014191,9,1388,1562,174,05-09-2021
1000014191,10,1429,1562,133,05-10-2021
1000014191,11,1472,1562,90,05-11-2021
1000014191,12,1519,1563,44,05-12-2021
1000014192,1,0,381,381,05-01-2021
1000014192,2,0,381,381,05-02-2021
1000014192,3,0,381,381,05-03-2021
1000014192,4,0,381,381,05-04-2021
1000014192,5,0,381,381,05-05-2021
1000014192,6,0,381,381,05-06-2021
1000014192,7,1963,2344,381,05-07-2021
1000014192,8,2022,2344,322,05-08-2021
1000014192,9,2083,2344,261,05-09-2021
1000014192,10,2145,2344,199,05-10-2021
1000014192,11,2209,2344,135,05-11-2021
1000014192,12,2278,2346,68,05-12-2021
1000014193,1,1856,2647,791,05-01-2021
1000014193,2,1912,2647,735,05-02-2021
1000014193,3,1970,2647,677,05-03-2021
1000014193,4,2029,2647,618,05-04-2021
1000014193,5,2090,2647,557,05-05-2021
1000014193,6,2152,2647,495,05-06-2021
1000014193,7,2217,2647,430,05-07-2021
1000014193,8,2283,2647,364,05-08-2021
1000014193,9,2352,2647,295,05-09-2021
1000014193,10,2422,2647,225,05-10-2021
1000014193,11,2495,2647,152,05-11-2021
1000014193,12,2572,2649,77,05-12-2021
1000014194,1,0,1019,1019,05-01-2021
1000014194,2,0,1019,1019,05-02-2021
1000014194,3,0,1019,1019,05-03-2021
1000014194,4,0,1019,1019,05-04-2021
1000014194,5,0,1019,1019,05-05-2021
1000014194,6,0,1019,1019,05-06-2021
1000014194,7,3822,4841,1019,05-07-2021
1000014194,8,3936,4841,905,05-08-2021
1000014194,9,4054,4841,787,05-09-2021
1000014194,10,4176,4841,665,05-10-2021
1000014194,11,4301,4841,540,05-11-2021
1000014194,12,4430,4841,411,05-12-2021
1000014194,13,4563,4841,278,05-01-2022
1000014194,14,4698,4838,140,05-02-2022
1000014195,1,0,393,393,05-01-2021
1000014195,2,0,393,393,05-02-2021
1000014195,3,0,393,393,05-03-2021
1000014195,4,0,393,393,05-04-2021
1000014195,5,0,393,393,05-05-2021
1000014195,6,0,393,393,05-06-2021
1000014195,7,4239,4632,393,05-07-2021
1000014195,8,4366,4632,266,05-08-2021
1000014195,9,4498,4633,135,05-09-2021
1000014196,1,1462,1646,184,05-01-2021
1000014196,2,1506,1646,140,05-02-2021
1000014196,3,1551,1646,95,05-03-2021
1000014196,4,1599,1646,47,05-04-2021
1000014197,1,0,261,261,05-02-2021
1000014197,2,0,261,261,05-03-2021
1000014197,3,0,261,261,05-04-2021
1000014197,4,0,261,261,05-05-2021
1000014197,5,0,261,261,05-06-2021
1000014197,6,0,261,261,05-07-2021
1000014197,7,2084,2345,261,05-08-2021
1000014197,8,2146,2345,199,05-09-2021
1000014197,9,2210,2345,135,05-10-2021
1000014197,10,2276,2344,68,05-11-2021
1000014198,1,0,330,330,05-02-2021
1000014198,2,0,330,330,05-03-2021
1000014198,3,0,330,330,05-04-2021
1000014198,4,0,330,330,05-05-2021
1000014198,5,0,330,330,05-06-2021
1000014198,6,0,330,330,05-07-2021
1000014198,7,2071,2401,330,05-08-2021
1000014198,8,2133,2401,268,05-09-2021
1000014198,9,2197,2401,204,05-10-2021
1000014198,10,2263,2401,138,05-11-2021
1000014198,11,2330,2399,69,05-12-2021
1000014199,1,966,1153,187,05-02-2021
1000014199,2,995,1153,158,05-03-2021
1000014199,3,1024,1153,129,05-04-2021
1000014199,4,1055,1153,98,05-05-2021
1000014199,5,1087,1153,66,05-06-2021
1000014199,6,1121,1155,34,05-07-2021
1000014200,1,950,1203,253,05-02-2021
1000014200,2,978,1203,225,05-03-2021
1000014200,3,1007,1203,196,05-04-2021
1000014200,4,1038,1203,165,05-05-2021
1000014200,5,1069,1203,134,05-06-2021
1000014200,6,1101,1203,102,05-07-2021
1000014200,7,1134,1203,69,05-08-2021
1000014200,8,1171,1206,35,05-09-2021
1000014201,1,979,1240,261,05-02-2021
1000014201,2,1008,1240,232,05-03-2021
1000014201,3,1039,1240,201,05-04-2021
1000014201,4,1070,1240,170,05-05-2021
1000014201,5,1102,1240,138,05-06-2021
1000014201,6,1135,1240,105,05-07-2021
1000014201,7,1169,1240,71,05-08-2021
1000014201,8,1200,1236,36,05-09-2021
1000014202,1,921,1100,179,05-02-2021
1000014202,2,949,1100,151,05-03-2021
1000014202,3,977,1100,123,05-04-2021
1000014202,4,1007,1100,93,05-05-2021
1000014202,5,1037,1100,63,05-06-2021
1000014202,6,1066,1098,32,05-07-2021
1000014203,1,1186,1502,316,05-02-2021
1000014203,2,1221,1502,281,05-03-2021
1000014203,3,1258,1502,244,05-04-2021
1000014203,4,1296,1502,206,05-05-2021
1000014203,5,1334,1502,168,05-06-2021
1000014203,6,1374,1502,128,05-07-2021
1000014203,7,1416,1502,86,05-08-2021
1000014203,8,1461,1505,44,05-09-2021
1000014204,1,1704,2734,1030,05-02-2021
1000014204,2,1755,2734,979,05-03-2021
1000014204,3,1807,2734,927,05-04-2021
1000014204,4,1862,2734,872,05-05-2021
1000014204,5,1917,2734,817,05-06-2021
1000014204,6,1975,2734,759,05-07-2021
1000014204,7,2034,2734,700,05-08-2021
1000014204,8,2095,2734,639,05-09-2021
1000014204,9,2158,2734,576,05-10-2021
1000014204,10,2223,2734,511,05-11-2021
1000014204,11,2290,2734,444,05-12-2021
1000014204,12,2358,2734,376,05-01-2022
1000014204,13,2429,2734,305,05-02-2022
1000014204,14,2502,2734,232,05-03-2022
1000014204,15,2577,2734,157,05-04-2022
1000014204,16,2660,2739,79,05-05-2022
1000014205,1,1420,2279,859,05-02-2021
1000014205,2,1463,2279,816,05-03-2021
1000014205,3,1507,2279,772,05-04-2021
1000014205,4,1552,2279,727,05-05-2021
1000014205,5,1599,2279,680,05-06-2021
1000014205,6,1647,2279,632,05-07-2021
1000014205,7,1696,2279,583,05-08-2021
1000014205,8,1747,2279,532,05-09-2021
1000014205,9,1799,2279,480,05-10-2021
1000014205,10,1853,2279,426,05-11-2021
1000014205,11,1909,2279,370,05-12-2021
1000014205,12,1966,2279,313,05-01-2022
1000014205,13,2025,2279,254,05-02-2022
1000014205,14,2086,2279,193,05-03-2022
1000014205,15,2148,2279,131,05-04-2022
1000014205,16,2206,2272,66,05-05-2022
1000014206,1,2924,3704,780,05-02-2021
1000014206,2,3012,3704,692,05-03-2021
1000014206,3,3102,3704,602,05-04-2021
1000014206,4,3195,3704,509,05-05-2021
1000014206,5,3291,3704,413,05-06-2021
1000014206,6,3390,3704,314,05-07-2021
1000014206,7,3491,3704,213,05-08-2021
1000014206,8,3595,3703,108,05-09-2021
1000014207,1,1704,2734,1030,05-02-2021
1000014207,2,1755,2734,979,05-03-2021
1000014207,3,1807,2734,927,05-04-2021
1000014207,4,1862,2734,872,05-05-2021
1000014207,5,1917,2734,817,05-06-2021
1000014207,6,1975,2734,759,05-07-2021
1000014207,7,2034,2734,700,05-08-2021
1000014207,8,2095,2734,639,05-09-2021
1000014207,9,2158,2734,576,05-10-2021
1000014207,10,2223,2734,511,05-11-2021
1000014207,11,2290,2734,444,05-12-2021
1000014207,12,2358,2734,376,05-01-2022
1000014207,13,2429,2734,305,05-02-2022
1000014207,14,2502,2734,232,05-03-2022
1000014207,15,2577,2734,157,05-04-2022
1000014207,16,2660,2739,79,05-05-2022
1000014208,1,2991,3789,798,05-02-2021
1000014208,2,3081,3789,708,05-03-2021
1000014208,3,3173,3789,616,05-04-2021
1000014208,4,3268,3789,521,05-05-2021
1000014208,5,3366,3789,423,05-06-2021
1000014208,6,3467,3789,322,05-07-2021
1000014208,7,3571,3789,218,05-08-2021
1000014208,8,3683,3792,109,05-09-2021
1000014209,1,2199,2475,276,05-02-2021
1000014209,2,2265,2475,210,05-03-2021
1000014209,3,2333,2475,142,05-04-2021
1000014209,4,2404,2476,72,05-05-2021
1000014210,1,1824,2600,776,05-02-2021
1000014210,2,1878,2600,722,05-03-2021
1000014210,3,1935,2600,665,05-04-2021
1000014210,4,1993,2600,607,05-05-2021
1000014210,5,2052,2600,548,05-06-2021
1000014210,6,2114,2600,486,05-07-2021
1000014210,7,2177,2600,423,05-08-2021
1000014210,8,2243,2600,357,05-09-2021
1000014210,9,2310,2600,290,05-10-2021
1000014210,10,2379,2600,221,05-11-2021
1000014210,11,2451,2600,149,05-12-2021
1000014210,12,2524,2600,76,05-01-2022
1000014211,1,1003,1271,268,05-02-2021
1000014211,2,1033,1271,238,05-03-2021
1000014211,3,1064,1271,207,05-04-2021
1000014211,4,1096,1271,175,05-05-2021
1000014211,5,1129,1271,142,05-06-2021
1000014211,6,1163,1271,108,05-07-2021
1000014211,7,1198,1271,73,05-08-2021
1000014211,8,1236,1271,35,05-09-2021
1000014212,1,0,390,390,05-02-2021
1000014212,2,0,390,390,05-03-2021
1000014212,3,0,390,390,05-04-2021
1000014212,4,0,390,390,05-05-2021
1000014212,5,0,390,390,05-06-2021
1000014212,6,0,390,390,05-07-2021
1000014212,7,2010,2400,390,05-08-2021
1000014212,8,2070,2400,330,05-09-2021
1000014212,9,2132,2400,268,05-10-2021
1000014212,10,2196,2400,204,05-11-2021
1000014212,11,2262,2400,138,05-12-2021
1000014212,12,2330,2399,69,05-01-2022
1000014213,1,1240,1481,241,05-02-2021
1000014213,2,1277,1481,204,05-03-2021
1000014213,3,1316,1481,165,05-04-2021
1000014213,4,1355,1481,126,05-05-2021
1000014213,5,1396,1481,85,05-06-2021
1000014213,6,1441,1483,42,05-07-2021
1000014214,1,0,442,442,05-02-2021
1000014214,2,0,442,442,05-03-2021
1000014214,3,0,442,442,05-04-2021
1000014214,4,0,442,442,05-05-2021
1000014214,5,0,442,442,05-06-2021
1000014214,6,0,442,442,05-07-2021
1000014214,7,2777,3219,442,05-08-2021
1000014214,8,2860,3219,359,05-09-2021
1000014214,9,2946,3219,273,05-10-2021
1000014214,10,3034,3219,185,05-11-2021
1000014214,11,3124,3218,94,05-12-2021
1000014215,1,1218,1842,624,05-02-2021
1000014215,2,1254,1842,588,05-03-2021
1000014215,3,1292,1842,550,05-04-2021
1000014215,4,1331,1842,511,05-05-2021
1000014215,5,1371,1842,471,05-06-2021
1000014215,6,1412,1842,430,05-07-2021
1000014215,7,1454,1842,388,05-08-2021
1000014215,8,1498,1842,344,05-09-2021
1000014215,9,1543,1842,299,05-10-2021
1000014215,10,1589,1842,253,05-11-2021
1000014215,11,1637,1842,205,05-12-2021
1000014215,12,1686,1842,156,05-01-2022
1000014215,13,1736,1842,106,05-02-2022
1000014215,14,1782,1835,53,05-03-2022
1000014216,1,959,1289,330,05-02-2021
1000014216,2,988,1289,301,05-03-2021
1000014216,3,1018,1289,271,05-04-2021
1000014216,4,1048,1289,241,05-05-2021
1000014216,5,1080,1289,209,05-06-2021
1000014216,6,1112,1289,177,05-07-2021
1000014216,7,1145,1289,144,05-08-2021
1000014216,8,1180,1289,109,05-09-2021
1000014216,9,1215,1289,74,05-10-2021
1000014216,10,1249,1286,37,05-11-2021
1000014217,1,0,72,72,05-02-2021
1000014217,2,0,72,72,05-03-2021
1000014217,3,0,72,72,05-04-2021
1000014217,4,0,72,72,05-05-2021
1000014217,5,0,72,72,05-06-2021
1000014217,6,0,72,72,05-07-2021
1000014217,7,2407,2479,72,05-08-2021
1000014218,1,0,390,390,05-02-2021
1000014218,2,0,390,390,05-03-2021
1000014218,3,0,390,390,05-04-2021
1000014218,4,0,390,390,05-05-2021
1000014218,5,0,390,390,05-06-2021
1000014218,6,0,390,390,05-07-2021
1000014218,7,2010,2400,390,05-08-2021
1000014218,8,2070,2400,330,05-09-2021
1000014218,9,2132,2400,268,05-10-2021
1000014218,10,2196,2400,204,05-11-2021
1000014218,11,2262,2400,138,05-12-2021
1000014218,12,2330,2399,69,05-01-2022
1000014219,1,0,1036,1036,05-02-2021
1000014219,2,0,1036,1036,05-03-2021
1000014219,3,0,1036,1036,05-04-2021
1000014219,4,0,1036,1036,05-05-2021
1000014219,5,0,1036,1036,05-06-2021
1000014219,6,0,1036,1036,05-07-2021
1000014219,7,3882,4918,1036,05-08-2021
1000014219,8,3999,4918,919,05-09-2021
1000014219,9,4119,4918,799,05-10-2021
1000014219,10,4242,4918,676,05-11-2021
1000014219,11,4370,4918,548,05-12-2021
1000014219,12,4501,4918,417,05-01-2022
1000014219,13,4636,4918,282,05-02-2022
1000014219,14,4775,4918,143,05-03-2022
1000014220,1,0,390,390,05-02-2021
1000014220,2,0,390,390,05-03-2021
1000014220,3,0,390,390,05-04-2021
1000014220,4,0,390,390,05-05-2021
1000014220,5,0,390,390,05-06-2021
1000014220,6,0,390,390,05-07-2021
1000014220,7,2010,2400,390,05-08-2021
1000014220,8,2070,2400,330,05-09-2021
1000014220,9,2132,2400,268,05-10-2021
1000014220,10,2196,2400,204,05-11-2021
1000014220,11,2262,2400,138,05-12-2021
1000014220,12,2330,2399,69,05-01-2022
1000014221,1,1240,1316,76,05-02-2021
1000014221,2,1279,1317,38,05-03-2021
1000014222,1,0,88,88,05-02-2021
1000014222,2,0,88,88,05-03-2021
1000014222,3,0,88,88,05-04-2021
1000014222,4,0,88,88,05-05-2021
1000014222,5,0,88,88,05-06-2021
1000014222,6,0,88,88,05-07-2021
1000014222,7,2931,3019,88,05-08-2021
1000014223,1,0,638,638,05-02-2021
1000014223,2,0,638,638,05-03-2021
1000014223,3,0,638,638,05-04-2021
1000014223,4,0,638,638,05-05-2021
1000014223,5,0,638,638,05-06-2021
1000014223,6,0,638,638,05-07-2021
1000014223,7,2778,3416,638,05-08-2021
1000014223,8,2861,3416,555,05-09-2021
1000014223,9,2947,3416,469,05-10-2021
1000014223,10,3035,3416,381,05-11-2021
1000014223,11,3126,3416,290,05-12-2021
1000014223,12,3220,3416,196,05-01-2022
1000014223,13,3316,3415,99,05-02-2022
1000014224,1,916,1306,390,05-02-2021
1000014224,2,943,1306,363,05-03-2021
1000014224,3,972,1306,334,05-04-2021
1000014224,4,1001,1306,305,05-05-2021
1000014224,5,1031,1306,275,05-06-2021
1000014224,6,1062,1306,244,05-07-2021
1000014224,7,1094,1306,212,05-08-2021
1000014224,8,1127,1306,179,05-09-2021
1000014224,9,1160,1306,146,05-10-2021
1000014224,10,1195,1306,111,05-11-2021
1000014224,11,1231,1306,75,05-12-2021
1000014224,12,1268,1306,38,05-01-2022
1000014225,1,1003,1271,268,05-02-2021
1000014225,2,1033,1271,238,05-03-2021
1000014225,3,1064,1271,207,05-04-2021
1000014225,4,1096,1271,175,05-05-2021
1000014225,5,1129,1271,142,05-06-2021
1000014225,6,1163,1271,108,05-07-2021
1000014225,7,1198,1271,73,05-08-2021
1000014225,8,1236,1271,35,05-09-2021
1000014226,1,1141,1725,584,05-02-2021
1000014226,2,1175,1725,550,05-03-2021
1000014226,3,1210,1725,515,05-04-2021
1000014226,4,1246,1725,479,05-05-2021
1000014226,5,1284,1725,441,05-06-2021
1000014226,6,1322,1725,403,05-07-2021
1000014226,7,1362,1725,363,05-08-2021
1000014226,8,1403,1725,322,05-09-2021
1000014226,9,1445,1725,280,05-10-2021
1000014226,10,1488,1725,237,05-11-2021
1000014226,11,1533,1725,192,05-12-2021
1000014226,12,1579,1725,146,05-01-2022
1000014226,13,1626,1725,99,05-02-2022
1000014226,14,1669,1719,50,05-03-2022
1000014227,1,1917,2899,982,05-02-2021
1000014227,2,1974,2899,925,05-03-2021
1000014227,3,2033,2899,866,05-04-2021
1000014227,4,2094,2899,805,05-05-2021
1000014227,5,2157,2899,742,05-06-2021
1000014227,6,2222,2899,677,05-07-2021
1000014227,7,2288,2899,611,05-08-2021
1000014227,8,2357,2899,542,05-09-2021
1000014227,9,2428,2899,471,05-10-2021
1000014227,10,2501,2899,398,05-11-2021
1000014227,11,2576,2899,323,05-12-2021
1000014227,12,2653,2899,246,05-01-2022
1000014227,13,2733,2899,166,05-02-2022
1000014227,14,2816,2900,84,05-03-2022
1000014228,1,1245,1775,530,05-02-2021
1000014228,2,1282,1775,493,05-03-2021
1000014228,3,1321,1775,454,05-04-2021
1000014228,4,1360,1775,415,05-05-2021
1000014228,5,1401,1775,374,05-06-2021
1000014228,6,1443,1775,332,05-07-2021
1000014228,7,1487,1775,288,05-08-2021
1000014228,8,1531,1775,244,05-09-2021
1000014228,9,1577,1775,198,05-10-2021
1000014228,10,1624,1775,151,05-11-2021
1000014228,11,1673,1775,102,05-12-2021
1000014228,12,1723,1773,50,05-01-2022
1000014229,1,0,507,507,05-02-2021
1000014229,2,0,507,507,05-03-2021
1000014229,3,0,507,507,05-04-2021
1000014229,4,0,507,507,05-05-2021
1000014229,5,0,507,507,05-06-2021
1000014229,6,0,507,507,05-07-2021
1000014229,7,4040,4547,507,05-08-2021
1000014229,8,4161,4547,386,05-09-2021
1000014229,9,4286,4547,261,05-10-2021
1000014229,10,4414,4546,132,05-11-2021
1000014230,1,0,561,561,05-02-2021
1000014230,2,0,561,561,05-03-2021
1000014230,3,0,561,561,05-04-2021
1000014230,4,0,561,561,05-05-2021
1000014230,5,0,561,561,05-06-2021
1000014230,6,0,561,561,05-07-2021
1000014230,7,3524,4085,561,05-08-2021
1000014230,8,3629,4085,456,05-09-2021
1000014230,9,3738,4085,347,05-10-2021
1000014230,10,3850,4085,235,05-11-2021
1000014230,11,3969,4087,118,05-12-2021
1000014231,1,1824,2600,776,05-02-2021
1000014231,2,1878,2600,722,05-03-2021
1000014231,3,1935,2600,665,05-04-2021
1000014231,4,1993,2600,607,05-05-2021
1000014231,5,2052,2600,548,05-06-2021
1000014231,6,2114,2600,486,05-07-2021
1000014231,7,2177,2600,423,05-08-2021
1000014231,8,2243,2600,357,05-09-2021
1000014231,9,2310,2600,290,05-10-2021
1000014231,10,2379,2600,221,05-11-2021
1000014231,11,2451,2600,149,05-12-2021
1000014231,12,2524,2600,76,05-01-2022
1000014232,1,916,1306,390,05-02-2021
1000014232,2,943,1306,363,05-03-2021
1000014232,3,972,1306,334,05-04-2021
1000014232,4,1001,1306,305,05-05-2021
1000014232,5,1031,1306,275,05-06-2021
1000014232,6,1062,1306,244,05-07-2021
1000014232,7,1094,1306,212,05-08-2021
1000014232,8,1127,1306,179,05-09-2021
1000014232,9,1160,1306,146,05-10-2021
1000014232,10,1195,1306,111,05-11-2021
1000014232,11,1231,1306,75,05-12-2021
1000014232,12,1268,1306,38,05-01-2022
1000014233,1,916,1306,390,05-02-2021
1000014233,2,943,1306,363,05-03-2021
1000014233,3,972,1306,334,05-04-2021
1000014233,4,1001,1306,305,05-05-2021
1000014233,5,1031,1306,275,05-06-2021
1000014233,6,1062,1306,244,05-07-2021
1000014233,7,1094,1306,212,05-08-2021
1000014233,8,1127,1306,179,05-09-2021
1000014233,9,1160,1306,146,05-10-2021
1000014233,10,1195,1306,111,05-11-2021
1000014233,11,1231,1306,75,05-12-2021
1000014233,12,1268,1306,38,05-01-2022
1000014234,1,0,390,390,05-02-2021
1000014234,2,0,390,390,05-03-2021
1000014234,3,0,390,390,05-04-2021
1000014234,4,0,390,390,05-05-2021
1000014234,5,0,390,390,05-06-2021
1000014234,6,0,390,390,05-07-2021
1000014234,7,2010,2400,390,05-08-2021
1000014234,8,2070,2400,330,05-09-2021
1000014234,9,2132,2400,268,05-10-2021
1000014234,10,2196,2400,204,05-11-2021
1000014234,11,2262,2400,138,05-12-2021
1000014234,12,2330,2399,69,05-01-2022
1000014235,1,0,110,110,05-02-2021
1000014235,2,0,110,110,05-03-2021
1000014235,3,0,110,110,05-04-2021
1000014235,4,0,110,110,05-05-2021
1000014235,5,0,110,110,05-06-2021
1000014235,6,0,110,110,05-07-2021
1000014235,7,1804,1914,110,05-08-2021
1000014235,8,1858,1914,56,05-09-2021
1000014236,1,1666,2836,1170,05-02-2021
1000014236,2,1716,2836,1120,05-03-2021
1000014236,3,1767,2836,1069,05-04-2021
1000014236,4,1820,2836,1016,05-05-2021
1000014236,5,1875,2836,961,05-06-2021
1000014236,6,1931,2836,905,05-07-2021
1000014236,7,1989,2836,847,05-08-2021
1000014236,8,2049,2836,787,05-09-2021
1000014236,9,2110,2836,726,05-10-2021
1000014236,10,2174,2836,662,05-11-2021
1000014236,11,2239,2836,597,05-12-2021
1000014236,12,2306,2836,530,05-01-2022
1000014236,13,2375,2836,461,05-02-2022
1000014236,14,2447,2836,389,05-03-2022
1000014236,15,2520,2836,316,05-04-2022
1000014236,16,2596,2836,240,05-05-2022
1000014236,17,2673,2836,163,05-06-2022
1000014236,18,2747,2829,82,05-07-2022
1000014237,1,0,313,313,05-02-2021
1000014237,2,0,313,313,05-03-2021
1000014237,3,0,313,313,05-04-2021
1000014237,4,0,313,313,05-05-2021
1000014237,5,0,313,313,05-06-2021
1000014237,6,0,313,313,05-07-2021
1000014237,7,2489,2802,313,05-08-2021
1000014237,8,2564,2802,238,05-09-2021
1000014237,9,2641,2802,161,05-10-2021
1000014237,10,2720,2802,82,05-11-2021
1000014237,11,2,2,0,05-12-2021
1000014238,1,0,134,134,05-02-2021
1000014238,2,0,134,134,05-03-2021
1000014238,3,0,134,134,05-04-2021
1000014238,4,0,134,134,05-05-2021
1000014238,5,0,134,134,05-06-2021
1000014238,6,0,134,134,05-07-2021
1000014238,7,2202,2336,134,05-08-2021
1000014238,8,2267,2335,68,05-09-2021
1000014239,1,2199,2475,276,05-02-2021
1000014239,2,2265,2475,210,05-03-2021
1000014239,3,2333,2475,142,05-04-2021
1000014239,4,2404,2476,72,05-05-2021
1000014240,1,0,309,309,05-02-2021
1000014240,2,0,309,309,05-03-2021
1000014240,3,0,309,309,05-04-2021
1000014240,4,0,309,309,05-05-2021
1000014240,5,0,309,309,05-06-2021
1000014240,6,0,309,309,05-07-2021
1000014240,7,2463,2772,309,05-08-2021
1000014240,8,2537,2772,235,05-09-2021
1000014240,9,2613,2772,159,05-10-2021
1000014240,10,2690,2771,81,05-11-2021
1000014241,1,0,146,146,05-02-2021
1000014241,2,0,146,146,05-03-2021
1000014241,3,0,146,146,05-04-2021
1000014241,4,0,146,146,05-05-2021
1000014241,5,0,146,146,05-06-2021
1000014241,6,0,146,146,05-07-2021
1000014241,7,4860,5006,146,05-08-2021
1000014242,1,1811,2162,351,05-02-2021
1000014242,2,1865,2162,297,05-03-2021
1000014242,3,1921,2162,241,05-04-2021
1000014242,4,1979,2162,183,05-05-2021
1000014242,5,2038,2162,124,05-06-2021
1000014242,6,2099,2162,63,05-07-2021
1000014243,1,0,390,390,05-02-2021
1000014243,2,0,390,390,05-03-2021
1000014243,3,0,390,390,05-04-2021
1000014243,4,0,390,390,05-05-2021
1000014243,5,0,390,390,05-06-2021
1000014243,6,0,390,390,05-07-2021
1000014243,7,6404,6794,390,05-08-2021
1000014243,8,6596,6794,198,05-09-2021
1000014244,1,0,143,143,05-02-2021
1000014244,2,0,143,143,05-03-2021
1000014244,3,0,143,143,05-04-2021
1000014244,4,0,143,143,05-05-2021
1000014244,5,0,143,143,05-06-2021
1000014244,6,0,143,143,05-07-2021
1000014244,7,2345,2488,143,05-08-2021
1000014244,8,2416,2488,72,05-09-2021
1000014245,1,957,1286,329,05-02-2021
1000014245,2,986,1286,300,05-03-2021
1000014245,3,1015,1286,271,05-04-2021
1000014245,4,1046,1286,240,05-05-2021
1000014245,5,1077,1286,209,05-06-2021
1000014245,6,1109,1286,177,05-07-2021
1000014245,7,1143,1286,143,05-08-2021
1000014245,8,1177,1286,109,05-09-2021
1000014245,9,1212,1286,74,05-10-2021
1000014245,10,1248,1285,37,05-11-2021
1000014246,1,0,180,180,05-02-2021
1000014246,2,0,180,180,05-03-2021
1000014246,3,0,180,180,05-04-2021
1000014246,4,0,180,180,05-05-2021
1000014246,5,0,180,180,05-06-2021
1000014246,6,0,180,180,05-07-2021
1000014246,7,2960,3140,180,05-08-2021
1000014246,8,3049,3140,91,05-09-2021
1000014247,1,1556,2219,663,05-02-2021
1000014247,2,1603,2219,616,05-03-2021
1000014247,3,1651,2219,568,05-04-2021
1000014247,4,1701,2219,518,05-05-2021
1000014247,5,1752,2219,467,05-06-2021
1000014247,6,1804,2219,415,05-07-2021
1000014247,7,1858,2219,361,05-08-2021
1000014247,8,1914,2219,305,05-09-2021
1000014247,9,1971,2219,248,05-10-2021
1000014247,10,2031,2219,188,05-11-2021
1000014247,11,2091,2219,128,05-12-2021
1000014247,12,2159,2223,64,05-01-2022
1000014248,1,959,1289,330,05-02-2021
1000014248,2,988,1289,301,05-03-2021
1000014248,3,1018,1289,271,05-04-2021
1000014248,4,1048,1289,241,05-05-2021
1000014248,5,1080,1289,209,05-06-2021
1000014248,6,1112,1289,177,05-07-2021
1000014248,7,1145,1289,144,05-08-2021
1000014248,8,1180,1289,109,05-09-2021
1000014248,9,1215,1289,74,05-10-2021
1000014248,10,1249,1286,37,05-11-2021
1000014249,1,0,264,264,05-02-2021
1000014249,2,1003,1271,268,05-03-2021
1000014249,3,1033,1271,238,05-04-2021
1000014249,4,1064,1271,207,05-05-2021
1000014249,5,1096,1271,175,05-06-2021
1000014249,6,1129,1271,142,05-07-2021
1000014249,7,1163,1271,108,05-08-2021
1000014249,8,1198,1271,73,05-09-2021
1000014249,9,1236,1271,35,05-10-2021
1000014250,1,1584,2006,422,05-02-2021
1000014250,2,1631,2006,375,05-03-2021
1000014250,3,1680,2006,326,05-04-2021
1000014250,4,1730,2006,276,05-05-2021
1000014250,5,1782,2006,224,05-06-2021
1000014250,6,1836,2006,170,05-07-2021
1000014250,7,1891,2006,115,05-08-2021
1000014250,8,1948,2006,58,05-09-2021
1000014253,1,1026,1225,199,05-02-2021
1000014253,2,1057,1225,168,05-03-2021
1000014253,3,1088,1225,137,05-04-2021
1000014253,4,1121,1225,104,05-05-2021
1000014253,5,1155,1225,70,05-06-2021
1000014253,6,1188,1224,36,05-07-2021
1000014254,1,1218,1842,624,05-02-2021
1000014254,2,1254,1842,588,05-03-2021
1000014254,3,1292,1842,550,05-04-2021
1000014254,4,1331,1842,511,05-05-2021
1000014254,5,1371,1842,471,05-06-2021
1000014254,6,1412,1842,430,05-07-2021
1000014254,7,1454,1842,388,05-08-2021
1000014254,8,1498,1842,344,05-09-2021
1000014254,9,1543,1842,299,05-10-2021
1000014254,10,1589,1842,253,05-11-2021
1000014254,11,1637,1842,205,05-12-2021
1000014254,12,1686,1842,156,05-01-2022
1000014254,13,1736,1842,106,05-02-2022
1000014254,14,1782,1835,53,05-03-2022
1000014266,1,0,723,723,05-02-2021
1000014266,2,0,723,723,05-03-2021
1000014266,3,0,723,723,05-04-2021
1000014266,4,0,723,723,05-05-2021
1000014266,5,0,723,723,05-06-2021
1000014266,6,0,723,723,05-07-2021
1000014266,7,7793,8516,723,05-08-2021
1000014266,8,8027,8516,489,05-09-2021
1000014266,9,8268,8516,248,05-10-2021
1000014278,1,1665,2518,853,05-02-2021
1000014278,2,1715,2518,803,05-03-2021
1000014278,3,1766,2518,752,05-04-2021
1000014278,4,1819,2518,699,05-05-2021
1000014278,5,1874,2518,644,05-06-2021
1000014278,6,1930,2518,588,05-07-2021
1000014278,7,1988,2518,530,05-08-2021
1000014278,8,2047,2518,471,05-09-2021
1000014278,9,2109,2518,409,05-10-2021
1000014278,10,2172,2518,346,05-11-2021
1000014278,11,2237,2518,281,05-12-2021
1000014278,12,2304,2518,214,05-01-2022
1000014278,13,2373,2518,145,05-02-2022
1000014278,14,2445,2518,73,05-03-2022
1000014280,1,1136,1823,687,05-02-2021
1000014280,2,1170,1823,653,05-03-2021
1000014280,3,1205,1823,618,05-04-2021
1000014280,4,1241,1823,582,05-05-2021
1000014280,5,1279,1823,544,05-06-2021
1000014280,6,1317,1823,506,05-07-2021
1000014280,7,1356,1823,467,05-08-2021
1000014280,8,1397,1823,426,05-09-2021
1000014280,9,1439,1823,384,05-10-2021
1000014280,10,1482,1823,341,05-11-2021
1000014280,11,1527,1823,296,05-12-2021
1000014280,12,1572,1823,251,05-01-2022
1000014280,13,1620,1823,203,05-02-2022
1000014280,14,1668,1823,155,05-03-2022
1000014280,15,1718,1823,105,05-04-2022
1000014280,16,1773,1824,51,05-05-2022
1000014281,1,0,235,235,05-02-2021
1000014281,2,0,235,235,05-03-2021
1000014281,3,0,235,235,05-04-2021
1000014281,4,0,235,235,05-05-2021
1000014281,5,0,235,235,05-06-2021
1000014281,6,0,235,235,05-07-2021
1000014281,7,3859,4094,235,05-08-2021
1000014281,8,3974,4093,119,05-09-2021
1000014282,1,1189,1799,610,05-02-2021
1000014282,2,1225,1799,574,05-03-2021
1000014282,3,1262,1799,537,05-04-2021
1000014282,4,1300,1799,499,05-05-2021
1000014282,5,1339,1799,460,05-06-2021
1000014282,6,1379,1799,420,05-07-2021
1000014282,7,1420,1799,379,05-08-2021
1000014282,8,1463,1799,336,05-09-2021
1000014282,9,1507,1799,292,05-10-2021
1000014282,10,1552,1799,247,05-11-2021
1000014282,11,1598,1799,201,05-12-2021
1000014282,12,1646,1799,153,05-01-2022
1000014282,13,1696,1799,103,05-02-2022
1000014282,14,1747,1799,52,05-03-2022
1000014283,1,1516,1810,294,05-02-2021
1000014283,2,1561,1810,249,05-03-2021
1000014283,3,1608,1810,202,05-04-2021
1000014283,4,1656,1810,154,05-05-2021
1000014283,5,1706,1810,104,05-06-2021
1000014283,6,1759,1811,52,05-07-2021
1000014284,1,0,268,268,05-02-2021
1000014284,2,0,268,268,05-03-2021
1000014284,3,0,268,268,05-04-2021
1000014284,4,0,268,268,05-05-2021
1000014284,5,0,268,268,05-06-2021
1000014284,6,0,268,268,05-07-2021
1000014284,7,2132,2400,268,05-08-2021
1000014284,8,2196,2400,204,05-09-2021
1000014284,9,2262,2400,138,05-10-2021
1000014284,10,2332,2401,69,05-11-2021
1000014286,1,1245,1775,530,05-02-2021
1000014286,2,1282,1775,493,05-03-2021
1000014286,3,1321,1775,454,05-04-2021
1000014286,4,1360,1775,415,05-05-2021
1000014286,5,1401,1775,374,05-06-2021
1000014286,6,1443,1775,332,05-07-2021
1000014286,7,1487,1775,288,05-08-2021
1000014286,8,1531,1775,244,05-09-2021
1000014286,9,1577,1775,198,05-10-2021
1000014286,10,1624,1775,151,05-11-2021
1000014286,11,1673,1775,102,05-12-2021
1000014286,12,1723,1773,50,05-01-2022
1000014291,1,916,1306,390,05-02-2021
1000014291,2,943,1306,363,05-03-2021
1000014291,3,972,1306,334,05-04-2021
1000014291,4,1001,1306,305,05-05-2021
1000014291,5,1031,1306,275,05-06-2021
1000014291,6,1062,1306,244,05-07-2021
1000014291,7,1094,1306,212,05-08-2021
1000014291,8,1127,1306,179,05-09-2021
1000014291,9,1160,1306,146,05-10-2021
1000014291,10,1195,1306,111,05-11-2021
1000014291,11,1231,1306,75,05-12-2021
1000014291,12,1268,1306,38,05-01-2022
1000014292,1,937,1259,322,05-02-2021
1000014292,2,965,1259,294,05-03-2021
1000014292,3,994,1259,265,05-04-2021
1000014292,4,1024,1259,235,05-05-2021
1000014292,5,1054,1259,205,05-06-2021
1000014292,6,1086,1259,173,05-07-2021
1000014292,7,1119,1259,140,05-08-2021
1000014292,8,1152,1259,107,05-09-2021
1000014292,9,1187,1259,72,05-10-2021
1000014292,10,1222,1259,37,05-11-2021
1000014293,1,2086,2213,127,05-02-2021
1000014293,1,2086,2213,127,05-02-2021
1000014293,2,2148,2212,64,05-03-2021
1000014293,2,2148,2212,64,05-03-2021
1000014294,1,0,639,639,05-02-2021
1000014294,2,1071,1719,648,05-03-2021
1000014294,3,1103,1719,616,05-04-2021
1000014294,4,1137,1719,582,05-05-2021
1000014294,5,1171,1719,548,05-06-2021
1000014294,6,1206,1719,513,05-07-2021
1000014294,7,1242,1719,477,05-08-2021
1000014294,8,1279,1719,440,05-09-2021
1000014294,9,1318,1719,401,05-10-2021
1000014294,10,1357,1719,362,05-11-2021
1000014294,11,1398,1719,321,05-12-2021
1000014294,12,1440,1719,279,05-01-2022
1000014294,13,1483,1719,236,05-02-2022
1000014294,14,1527,1719,192,05-03-2022
1000014294,15,1573,1719,146,05-04-2022
1000014294,16,1620,1719,99,05-05-2022
1000014294,17,1665,1715,50,05-06-2022
1000014295,1,1212,1447,235,05-02-2021
1000014295,2,1248,1447,199,05-03-2021
1000014295,3,1286,1447,161,05-04-2021
1000014295,4,1324,1447,123,05-05-2021
1000014295,5,1364,1447,83,05-06-2021
1000014295,6,1406,1448,42,05-07-2021
1000014302,1,0,1030,1030,05-02-2021
1000014302,2,0,1030,1030,05-03-2021
1000014302,3,0,1030,1030,05-04-2021
1000014302,4,0,1030,1030,05-05-2021
1000014302,5,0,1030,1030,05-06-2021
1000014302,6,0,1030,1030,05-07-2021
1000014302,7,3863,4893,1030,05-08-2021
1000014302,8,3979,4893,914,05-09-2021
1000014302,9,4098,4893,795,05-10-2021
1000014302,10,4221,4893,672,05-11-2021
1000014302,11,4347,4893,546,05-12-2021
1000014302,12,4478,4893,415,05-01-2022
1000014302,13,4612,4893,281,05-02-2022
1000014302,14,4748,4890,142,05-03-2022
1000014303,1,0,199,199,05-02-2021
1000014303,2,0,199,199,05-03-2021
1000014303,3,0,199,199,05-04-2021
1000014303,4,0,199,199,05-05-2021
1000014303,5,0,199,199,05-06-2021
1000014303,6,0,199,199,05-07-2021
1000014303,7,2147,2346,199,05-08-2021
1000014303,8,2211,2346,135,05-09-2021
1000014303,9,2277,2345,68,05-10-2021
1000014304,1,2585,3274,689,05-02-2021
1000014304,2,2662,3274,612,05-03-2021
1000014304,3,2742,3274,532,05-04-2021
1000014304,4,2824,3274,450,05-05-2021
1000014304,5,2909,3274,365,05-06-2021
1000014304,6,2996,3274,278,05-07-2021
1000014304,7,3086,3274,188,05-08-2021
1000014304,8,3179,3274,95,05-09-2021
1000014307,1,2342,3147,805,05-02-2021
1000014307,2,2412,3147,735,05-03-2021
1000014307,3,2484,3147,663,05-04-2021
1000014307,4,2559,3147,588,05-05-2021
1000014307,5,2636,3147,511,05-06-2021
1000014307,6,2715,3147,432,05-07-2021
1000014307,7,2796,3147,351,05-08-2021
1000014307,8,2880,3147,267,05-09-2021
1000014307,9,2966,3147,181,05-10-2021
1000014307,10,3051,3143,92,05-11-2021
1000014311,1,1007,1276,269,05-02-2021
1000014311,2,1038,1276,238,05-03-2021
1000014311,3,1069,1276,207,05-04-2021
1000014311,4,1101,1276,175,05-05-2021
1000014311,5,1134,1276,142,05-06-2021
1000014311,6,1168,1276,108,05-07-2021
1000014311,7,1203,1276,73,05-08-2021
1000014311,8,1236,1273,37,05-09-2021
1000014312,1,959,1289,330,05-02-2021
1000014312,2,988,1289,301,05-03-2021
1000014312,3,1018,1289,271,05-04-2021
1000014312,4,1048,1289,241,05-05-2021
1000014312,5,1080,1289,209,05-06-2021
1000014312,6,1112,1289,177,05-07-2021
1000014312,7,1145,1289,144,05-08-2021
1000014312,8,1180,1289,109,05-09-2021
1000014312,9,1215,1289,74,05-10-2021
1000014312,10,1249,1286,37,05-11-2021
1000014317,1,1462,1852,390,05-02-2021
1000014317,2,1506,1852,346,05-03-2021
1000014317,3,1551,1852,301,05-04-2021
1000014317,4,1598,1852,254,05-05-2021
1000014317,5,1646,1852,206,05-06-2021
1000014317,6,1695,1852,157,05-07-2021
1000014317,7,1746,1852,106,05-08-2021
1000014317,8,1796,1850,54,05-09-2021
1000014327,1,1237,1392,155,05-02-2021
1000014327,2,1274,1392,118,05-03-2021
1000014327,3,1312,1392,80,05-04-2021
1000014327,4,1353,1394,41,05-05-2021
1000014342,1,0,659,659,05-02-2021
1000014342,2,0,659,659,05-03-2021
1000014342,3,0,659,659,05-04-2021
1000014342,4,0,659,659,05-05-2021
1000014342,5,0,659,659,05-06-2021
1000014342,6,0,659,659,05-07-2021
1000014342,7,4139,4798,659,05-08-2021
1000014342,8,4263,4798,535,05-09-2021
1000014342,9,4391,4798,407,05-10-2021
1000014342,10,4523,4798,275,05-11-2021
1000014342,11,4658,4798,140,05-12-2021
1000014343,1,1110,1890,780,05-02-2021
1000014343,2,1143,1890,747,05-03-2021
1000014343,3,1178,1890,712,05-04-2021
1000014343,4,1213,1890,677,05-05-2021
1000014343,5,1249,1890,641,05-06-2021
1000014343,6,1287,1890,603,05-07-2021
1000014343,7,1325,1890,565,05-08-2021
1000014343,8,1365,1890,525,05-09-2021
1000014343,9,1406,1890,484,05-10-2021
1000014343,10,1448,1890,442,05-11-2021
1000014343,11,1492,1890,398,05-12-2021
1000014343,12,1536,1890,354,05-01-2022
1000014343,13,1583,1890,307,05-02-2022
1000014343,14,1630,1890,260,05-03-2022
1000014343,15,1679,1890,211,05-04-2022
1000014343,16,1729,1890,161,05-05-2022
1000014343,17,1781,1890,109,05-06-2022
1000014343,18,1846,1898,52,05-07-2022
1000014344,1,2934,3717,783,05-02-2021
1000014344,2,3022,3717,695,05-03-2021
1000014344,3,3113,3717,604,05-04-2021
1000014344,4,3206,3717,511,05-05-2021
1000014344,5,3302,3717,415,05-06-2021
1000014344,6,3402,3717,315,05-07-2021
1000014344,7,3504,3717,213,05-08-2021
1000014344,8,3610,3718,108,05-09-2021
1000014348,1,959,1289,330,05-02-2021
1000014348,2,988,1289,301,05-03-2021
1000014348,3,1018,1289,271,05-04-2021
1000014348,4,1048,1289,241,05-05-2021
1000014348,5,1080,1289,209,05-06-2021
1000014348,6,1112,1289,177,05-07-2021
1000014348,7,1145,1289,144,05-08-2021
1000014348,8,1180,1289,109,05-09-2021
1000014348,9,1215,1289,74,05-10-2021
1000014348,10,1249,1286,37,05-11-2021
1000014354,1,0,563,563,05-02-2021
1000014354,2,0,563,563,05-03-2021
1000014354,3,0,563,563,05-04-2021
1000014354,4,0,563,563,05-05-2021
1000014354,5,0,563,563,05-06-2021
1000014354,6,0,563,563,05-07-2021
1000014354,7,3531,4094,563,05-08-2021
1000014354,8,3637,4094,457,05-09-2021
1000014354,9,3747,4094,347,05-10-2021
1000014354,10,3859,4094,235,05-11-2021
1000014354,11,3976,4095,119,05-12-2021
1000014367,1,1267,1426,159,05-02-2021
1000014367,2,1305,1426,121,05-03-2021
1000014367,3,1344,1426,82,05-04-2021
1000014367,4,1385,1426,41,05-05-2021
1000014375,1,937,1259,322,05-02-2021
1000014375,2,965,1259,294,05-03-2021
1000014375,3,994,1259,265,05-04-2021
1000014375,4,1024,1259,235,05-05-2021
1000014375,5,1054,1259,205,05-06-2021
1000014375,6,1086,1259,173,05-07-2021
1000014375,7,1119,1259,140,05-08-2021
1000014375,8,1152,1259,107,05-09-2021
1000014375,9,1187,1259,72,05-10-2021
1000014375,10,1222,1259,37,05-11-2021
1000014379,1,1085,1847,762,05-02-2021
1000014379,2,1118,1847,729,05-03-2021
1000014379,3,1151,1847,696,05-04-2021
1000014379,4,1186,1847,661,05-05-2021
1000014379,5,1221,1847,626,05-06-2021
1000014379,6,1258,1847,589,05-07-2021
1000014379,7,1296,1847,551,05-08-2021
1000014379,8,1334,1847,513,05-09-2021
1000014379,9,1374,1847,473,05-10-2021
1000014379,10,1416,1847,431,05-11-2021
1000014379,11,1458,1847,389,05-12-2021
1000014379,12,1502,1847,345,05-01-2022
1000014379,13,1547,1847,300,05-02-2022
1000014379,14,1593,1847,254,05-03-2022
1000014379,15,1641,1847,206,05-04-2022
1000014379,16,1690,1847,157,05-05-2022
1000014379,17,1741,1847,106,05-06-2022
1000014379,18,1789,1843,54,05-07-2022
1000014380,1,958,1366,408,05-02-2021
1000014380,2,987,1366,379,05-03-2021
1000014380,3,1016,1366,350,05-04-2021
1000014380,4,1047,1366,319,05-05-2021
1000014380,5,1078,1366,288,05-06-2021
1000014380,6,1111,1366,255,05-07-2021
1000014380,7,1144,1366,222,05-08-2021
1000014380,8,1178,1366,188,05-09-2021
1000014380,9,1214,1366,152,05-10-2021
1000014380,10,1250,1366,116,05-11-2021
1000014380,11,1287,1366,79,05-12-2021
1000014380,12,1330,1369,39,05-01-2022
1000014393,1,916,1306,390,05-02-2021
1000014393,2,943,1306,363,05-03-2021
1000014393,3,972,1306,334,05-04-2021
1000014393,4,1001,1306,305,05-05-2021
1000014393,5,1031,1306,275,05-06-2021
1000014393,6,1062,1306,244,05-07-2021
1000014393,7,1094,1306,212,05-08-2021
1000014393,8,1127,1306,179,05-09-2021
1000014393,9,1160,1306,146,05-10-2021
1000014393,10,1195,1306,111,05-11-2021
1000014393,11,1231,1306,75,05-12-2021
1000014393,12,1268,1306,38,05-01-2022
1000014394,1,2027,2281,254,05-02-2021
1000014394,2,2087,2281,194,05-03-2021
1000014394,3,2150,2281,131,05-04-2021
1000014394,4,2213,2279,66,05-05-2021
1000014395,1,1010,1279,269,05-02-2021
1000014395,2,1040,1279,239,05-03-2021
1000014395,3,1071,1279,208,05-04-2021
1000014395,4,1103,1279,176,05-05-2021
1000014395,5,1136,1279,143,05-06-2021
1000014395,6,1170,1279,109,05-07-2021
1000014395,7,1205,1279,74,05-08-2021
1000014395,8,1245,1281,36,05-09-2021
1000014397,1,979,1240,261,05-02-2021
1000014397,2,1008,1240,232,05-03-2021
1000014397,3,1039,1240,201,05-04-2021
1000014397,4,1070,1240,170,05-05-2021
1000014397,5,1102,1240,138,05-06-2021
1000014397,6,1135,1240,105,05-07-2021
1000014397,7,1169,1240,71,05-08-2021
1000014397,8,1200,1236,36,05-09-2021
1000014398,1,1826,2762,936,05-02-2021
1000014398,2,1881,2762,881,05-03-2021
1000014398,3,1937,2762,825,05-04-2021
1000014398,4,1995,2762,767,05-05-2021
1000014398,5,2055,2762,707,05-06-2021
1000014398,6,2117,2762,645,05-07-2021
1000014398,7,2180,2762,582,05-08-2021
1000014398,8,2246,2762,516,05-09-2021
1000014398,9,2313,2762,449,05-10-2021
1000014398,10,2382,2762,380,05-11-2021
1000014398,11,2454,2762,308,05-12-2021
1000014398,12,2527,2762,235,05-01-2022
1000014398,13,2603,2762,159,05-02-2022
1000014398,14,2689,2768,79,05-03-2022
1000014399,1,1136,1823,687,05-02-2021
1000014399,2,1170,1823,653,05-03-2021
1000014399,3,1205,1823,618,05-04-2021
1000014399,4,1241,1823,582,05-05-2021
1000014399,5,1279,1823,544,05-06-2021
1000014399,6,1317,1823,506,05-07-2021
1000014399,7,1356,1823,467,05-08-2021
1000014399,8,1397,1823,426,05-09-2021
1000014399,9,1439,1823,384,05-10-2021
1000014399,10,1482,1823,341,05-11-2021
1000014399,11,1527,1823,296,05-12-2021
1000014399,12,1572,1823,251,05-01-2022
1000014399,13,1620,1823,203,05-02-2022
1000014399,14,1668,1823,155,05-03-2022
1000014399,15,1718,1823,105,05-04-2022
1000014399,16,1773,1824,51,05-05-2022
1000014429,1,1953,2072,119,05-02-2021
1000014429,2,2011,2071,60,05-03-2021
1000014430,1,0,398,398,05-02-2021
1000014430,2,2082,2486,404,05-03-2021
1000014430,3,2145,2486,341,05-04-2021
1000014430,4,2209,2486,277,05-05-2021
1000014430,5,2275,2486,211,05-06-2021
1000014430,6,2343,2486,143,05-07-2021
1000014430,7,2411,2483,72,05-08-2021
1000014431,1,0,57,57,05-02-2021
1000014431,2,0,57,57,05-03-2021
1000014431,3,0,57,57,05-04-2021
1000014431,4,0,57,57,05-05-2021
1000014431,5,0,57,57,05-06-2021
1000014431,6,0,57,57,05-07-2021
1000014431,7,1898,1955,57,05-08-2021
1000014486,1,1159,1468,309,05-02-2021
1000014486,2,1194,1468,274,05-03-2021
1000014486,3,1229,1468,239,05-04-2021
1000014486,4,1266,1468,202,05-05-2021
1000014486,5,1304,1468,164,05-06-2021
1000014486,6,1343,1468,125,05-07-2021
1000014486,7,1384,1468,84,05-08-2021
1000014486,8,1424,1466,42,05-09-2021
1000014487,1,916,1306,390,05-02-2021
1000014487,2,943,1306,363,05-03-2021
1000014487,3,972,1306,334,05-04-2021
1000014487,4,1001,1306,305,05-05-2021
1000014487,5,1031,1306,275,05-06-2021
1000014487,6,1062,1306,244,05-07-2021
1000014487,7,1094,1306,212,05-08-2021
1000014487,8,1127,1306,179,05-09-2021
1000014487,9,1160,1306,146,05-10-2021
1000014487,10,1195,1306,111,05-11-2021
1000014487,11,1231,1306,75,05-12-2021
1000014487,12,1268,1306,38,05-01-2022
1000014488,1,0,506,506,05-02-2021
1000014488,2,0,506,506,05-03-2021
1000014488,3,0,506,506,05-04-2021
1000014488,4,0,506,506,05-05-2021
1000014488,5,0,506,506,05-06-2021
1000014488,6,0,506,506,05-07-2021
1000014488,7,4028,4534,506,05-08-2021
1000014488,8,4149,4534,385,05-09-2021
1000014488,9,4274,4534,260,05-10-2021
1000014488,10,4401,4533,132,05-11-2021
1000014492,1,1044,1175,131,05-02-2021
1000014492,2,1075,1175,100,05-03-2021
1000014492,3,1108,1175,67,05-04-2021
1000014492,4,1141,1175,34,05-05-2021
1000014494,1,1978,2658,680,05-02-2021
1000014494,2,2037,2658,621,05-03-2021
1000014494,3,2098,2658,560,05-04-2021
1000014494,4,2161,2658,497,05-05-2021
1000014494,5,2226,2658,432,05-06-2021
1000014494,6,2293,2658,365,05-07-2021
1000014494,7,2362,2658,296,05-08-2021
1000014494,8,2432,2658,226,05-09-2021
1000014494,9,2505,2658,153,05-10-2021
1000014494,10,2582,2659,77,05-11-2021
1000014511,1,0,899,899,05-02-2021
1000014511,2,0,899,899,05-03-2021
1000014511,3,0,899,899,05-04-2021
1000014511,4,0,899,899,05-05-2021
1000014511,5,0,899,899,05-06-2021
1000014511,6,0,899,899,05-07-2021
1000014511,7,3371,4270,899,05-08-2021
1000014511,8,3472,4270,798,05-09-2021
1000014511,9,3576,4270,694,05-10-2021
1000014511,10,3683,4270,587,05-11-2021
1000014511,11,3794,4270,476,05-12-2021
1000014511,12,3908,4270,362,05-01-2022
1000014511,13,4025,4270,245,05-02-2022
1000014511,14,4146,4270,124,05-03-2022
1000014512,1,1427,2034,607,05-02-2021
1000014512,2,1469,2034,565,05-03-2021
1000014512,3,1514,2034,520,05-04-2021
1000014512,4,1559,2034,475,05-05-2021
1000014512,5,1606,2034,428,05-06-2021
1000014512,6,1654,2034,380,05-07-2021
1000014512,7,1704,2034,330,05-08-2021
1000014512,8,1755,2034,279,05-09-2021
1000014512,9,1807,2034,227,05-10-2021
1000014512,10,1861,2034,173,05-11-2021
1000014512,11,1917,2034,117,05-12-2021
1000014512,12,1972,2031,59,05-01-2022
1000014513,1,1076,1285,209,05-02-2021
1000014513,2,1108,1285,177,05-03-2021
1000014513,3,1142,1285,143,05-04-2021
1000014513,4,1176,1285,109,05-05-2021
1000014513,5,1211,1285,74,05-06-2021
1000014513,6,1250,1287,37,05-07-2021
1000014517,1,0,685,685,05-02-2021
1000014517,2,0,685,685,05-03-2021
1000014517,3,0,685,685,05-04-2021
1000014517,4,0,685,685,05-05-2021
1000014517,5,0,685,685,05-06-2021
1000014517,6,0,685,685,05-07-2021
1000014517,7,4300,4985,685,05-08-2021
1000014517,8,4429,4985,556,05-09-2021
1000014517,9,4562,4985,423,05-10-2021
1000014517,10,4699,4985,286,05-11-2021
1000014517,11,4841,4986,145,05-12-2021
1000014523,1,1002,1196,194,05-02-2021
1000014523,2,1032,1196,164,05-03-2021
1000014523,3,1063,1196,133,05-04-2021
1000014523,4,1095,1196,101,05-05-2021
1000014523,5,1127,1196,69,05-06-2021
1000014523,6,1159,1194,35,05-07-2021
1000014530,1,0,753,753,05-02-2021
1000014530,2,0,753,753,05-03-2021
1000014530,3,0,753,753,05-04-2021
1000014530,4,0,753,753,05-05-2021
1000014530,5,0,753,753,05-06-2021
1000014530,6,0,753,753,05-07-2021
1000014530,7,3877,4630,753,05-08-2021
1000014530,8,3994,4630,636,05-09-2021
1000014530,9,4114,4630,516,05-10-2021
1000014530,10,4237,4630,393,05-11-2021
1000014530,11,4364,4630,266,05-12-2021
1000014530,12,4498,4633,135,05-01-2022
1000014538,1,916,1306,390,05-02-2021
1000014538,2,943,1306,363,05-03-2021
1000014538,3,972,1306,334,05-04-2021
1000014538,4,1001,1306,305,05-05-2021
1000014538,5,1031,1306,275,05-06-2021
1000014538,6,1062,1306,244,05-07-2021
1000014538,7,1094,1306,212,05-08-2021
1000014538,8,1127,1306,179,05-09-2021
1000014538,9,1160,1306,146,05-10-2021
1000014538,10,1195,1306,111,05-11-2021
1000014538,11,1231,1306,75,05-12-2021
1000014538,12,1268,1306,38,05-01-2022
1000014548,1,0,780,780,05-02-2021
1000014548,2,0,780,780,05-03-2021
1000014548,3,0,780,780,05-04-2021
1000014548,4,0,780,780,05-05-2021
1000014548,5,0,780,780,05-06-2021
1000014548,6,0,780,780,05-07-2021
1000014548,7,4018,4798,780,05-08-2021
1000014548,8,4139,4798,659,05-09-2021
1000014548,9,4263,4798,535,05-10-2021
1000014548,10,4391,4798,407,05-11-2021
1000014548,11,4523,4798,275,05-12-2021
1000014548,12,4660,4800,140,05-01-2022
1000014549,1,0,893,893,05-02-2021
1000014549,2,0,893,893,05-03-2021
1000014549,3,0,893,893,05-04-2021
1000014549,4,0,893,893,05-05-2021
1000014549,5,0,893,893,05-06-2021
1000014549,6,0,893,893,05-07-2021
1000014549,7,3884,4777,893,05-08-2021
1000014549,8,4001,4777,776,05-09-2021
1000014549,9,4121,4777,656,05-10-2021
1000014549,10,4244,4777,533,05-11-2021
1000014549,11,4372,4777,405,05-12-2021
1000014549,12,4503,4777,274,05-01-2022
1000014549,13,4640,4779,139,05-02-2022
1000014550,1,1942,2610,668,05-02-2021
1000014550,2,2000,2610,610,05-03-2021
1000014550,3,2060,2610,550,05-04-2021
1000014550,4,2122,2610,488,05-05-2021
1000014550,5,2186,2610,424,05-06-2021
1000014550,6,2251,2610,359,05-07-2021
1000014550,7,2319,2610,291,05-08-2021
1000014550,8,2388,2610,222,05-09-2021
1000014550,9,2460,2610,150,05-10-2021
1000014550,10,2537,2611,74,05-11-2021
1000014551,1,2249,2386,137,05-02-2021
1000014551,2,2317,2386,69,05-03-2021
1000014552,1,1949,2469,520,05-02-2021
1000014552,2,2008,2469,461,05-03-2021
1000014552,3,2068,2469,401,05-04-2021
1000014552,4,2130,2469,339,05-05-2021
1000014552,5,2194,2469,275,05-06-2021
1000014552,6,2260,2469,209,05-07-2021
1000014552,7,2327,2469,142,05-08-2021
1000014552,8,2395,2467,72,05-09-2021
1000014553,1,0,201,201,05-02-2021
1000014553,2,0,201,201,05-03-2021
1000014553,3,0,201,201,05-04-2021
1000014553,4,0,201,201,05-05-2021
1000014553,5,0,201,201,05-06-2021
1000014553,6,0,201,201,05-07-2021
1000014553,7,2171,2372,201,05-08-2021
1000014553,8,2236,2372,136,05-09-2021
1000014553,9,2302,2371,69,05-10-2021
1000014554,1,0,146,146,05-02-2021
1000014554,2,0,146,146,05-03-2021
1000014554,3,0,146,146,05-04-2021
1000014554,4,0,146,146,05-05-2021
1000014554,5,0,146,146,05-06-2021
1000014554,6,0,146,146,05-07-2021
1000014554,7,2405,2551,146,05-08-2021
1000014554,8,2476,2550,74,05-09-2021
1000014555,1,1026,1225,199,05-02-2021
1000014555,2,1057,1225,168,05-03-2021
1000014555,3,1088,1225,137,05-04-2021
1000014555,4,1121,1225,104,05-05-2021
1000014555,5,1155,1225,70,05-06-2021
1000014555,6,1188,1224,36,05-07-2021
1000014556,1,1666,2836,1170,05-02-2021
1000014556,2,1716,2836,1120,05-03-2021
1000014556,3,1767,2836,1069,05-04-2021
1000014556,4,1820,2836,1016,05-05-2021
1000014556,5,1875,2836,961,05-06-2021
1000014556,6,1931,2836,905,05-07-2021
1000014556,7,1989,2836,847,05-08-2021
1000014556,8,2049,2836,787,05-09-2021
1000014556,9,2110,2836,726,05-10-2021
1000014556,10,2174,2836,662,05-11-2021
1000014556,11,2239,2836,597,05-12-2021
1000014556,12,2306,2836,530,05-01-2022
1000014556,13,2375,2836,461,05-02-2022
1000014556,14,2447,2836,389,05-03-2022
1000014556,15,2520,2836,316,05-04-2022
1000014556,16,2596,2836,240,05-05-2022
1000014556,17,2673,2836,163,05-06-2022
1000014556,18,2747,2829,82,05-07-2022
1000014557,1,0,879,879,05-02-2021
1000014557,2,0,879,879,05-03-2021
1000014557,3,0,879,879,05-04-2021
1000014557,4,0,879,879,05-05-2021
1000014557,5,0,879,879,05-06-2021
1000014557,6,0,879,879,05-07-2021
1000014557,7,3295,4174,879,05-08-2021
1000014557,8,3394,4174,780,05-09-2021
1000014557,9,3496,4174,678,05-10-2021
1000014557,10,3601,4174,573,05-11-2021
1000014557,11,3709,4174,465,05-12-2021
1000014557,12,3820,4174,354,05-01-2022
1000014557,13,3934,4174,240,05-02-2022
1000014557,14,4050,4172,122,05-03-2022
1000014558,1,0,82,82,05-02-2021
1000014558,2,0,82,82,05-03-2021
1000014558,3,0,82,82,05-04-2021
1000014558,4,0,82,82,05-05-2021
1000014558,5,0,82,82,05-06-2021
1000014558,6,0,82,82,05-07-2021
1000014558,7,2740,2822,82,05-08-2021
1000014559,1,0,146,146,05-02-2021
1000014559,2,0,146,146,05-03-2021
1000014559,3,0,146,146,05-04-2021
1000014559,4,0,146,146,05-05-2021
1000014559,5,0,146,146,05-06-2021
1000014559,6,0,146,146,05-07-2021
1000014559,7,2405,2551,146,05-08-2021
1000014559,8,2476,2550,74,05-09-2021
1000014560,1,0,169,169,05-02-2021
1000014560,2,0,169,169,05-03-2021
1000014560,3,0,169,169,05-04-2021
1000014560,4,0,169,169,05-05-2021
1000014560,5,0,169,169,05-06-2021
1000014560,6,0,169,169,05-07-2021
1000014560,7,2777,2946,169,05-08-2021
1000014560,8,2860,2946,86,05-09-2021
1000014570,1,98,283,185,05-02-2021
1000014570,2,101,283,182,05-03-2021
1000014570,3,104,283,179,05-04-2021
1000014570,4,107,283,176,05-05-2021
1000014570,5,110,283,173,05-06-2021
1000014570,6,113,283,170,05-07-2021
1000014570,7,117,283,166,05-08-2021
1000014570,8,120,283,163,05-09-2021
1000014570,9,124,283,159,05-10-2021
1000014570,10,128,283,155,05-11-2021
1000014570,11,131,283,152,05-12-2021
1000014570,12,135,283,148,05-01-2022
1000014570,13,139,283,144,05-02-2022
1000014570,14,144,283,139,05-03-2022
1000014570,15,148,283,135,05-04-2022
1000014570,16,152,283,131,05-05-2022
1000014570,17,157,283,126,05-06-2022
1000014570,18,162,283,121,05-07-2022
1000014570,19,166,283,117,05-08-2022
1000014570,20,171,283,112,05-09-2022
1000014570,21,177,283,106,05-10-2022
1000014570,22,182,283,101,05-11-2022
1000014570,23,187,283,96,05-12-2022
1000014570,24,193,283,90,05-01-2023
1000014570,25,199,283,84,05-02-2023
1000014570,26,205,283,78,05-03-2023
1000014570,27,211,283,72,05-04-2023
1000014570,28,217,283,66,05-05-2023
1000014570,29,224,283,59,05-06-2023
1000014570,30,230,283,53,05-07-2023
1000014570,31,237,283,46,05-08-2023
1000014570,32,244,283,39,05-09-2023
1000014570,33,252,283,31,05-10-2023
1000014570,34,259,283,24,05-11-2023
1000014570,35,267,283,16,05-12-2023
1000014570,36,263,271,8,05-01-2024
1000014582,1,0,146,146,05-02-2021
1000014582,2,0,146,146,05-03-2021
1000014582,3,0,146,146,05-04-2021
1000014582,4,0,146,146,05-05-2021
1000014582,5,0,146,146,05-06-2021
1000014582,6,0,146,146,05-07-2021
1000014582,7,2405,2551,146,05-08-2021
1000014582,8,2476,2550,74,05-09-2021
1000014583,1,0,780,780,05-02-2021
1000014583,2,0,780,780,05-03-2021
1000014583,3,0,780,780,05-04-2021
1000014583,4,0,780,780,05-05-2021
1000014583,5,0,780,780,05-06-2021
1000014583,6,0,780,780,05-07-2021
1000014583,7,4018,4798,780,05-08-2021
1000014583,8,4139,4798,659,05-09-2021
1000014583,9,4263,4798,535,05-10-2021
1000014583,10,4391,4798,407,05-11-2021
1000014583,11,4523,4798,275,05-12-2021
1000014583,12,4660,4800,140,05-01-2022
1000014584,1,1113,1253,140,05-02-2021
1000014584,2,1147,1253,106,05-03-2021
1000014584,3,1181,1253,72,05-04-2021
1000014584,4,1216,1252,36,05-05-2021
1000014585,1,0,146,146,05-02-2021
1000014585,2,0,146,146,05-03-2021
1000014585,3,0,146,146,05-04-2021
1000014585,4,0,146,146,05-05-2021
1000014585,5,0,146,146,05-06-2021
1000014585,6,0,146,146,05-07-2021
1000014585,7,2405,2551,146,05-08-2021
1000014585,8,2476,2550,74,05-09-2021
1000014586,1,937,1259,322,05-02-2021
1000014586,2,965,1259,294,05-03-2021
1000014586,3,994,1259,265,05-04-2021
1000014586,4,1024,1259,235,05-05-2021
1000014586,5,1054,1259,205,05-06-2021
1000014586,6,1086,1259,173,05-07-2021
1000014586,7,1119,1259,140,05-08-2021
1000014586,8,1152,1259,107,05-09-2021
1000014586,9,1187,1259,72,05-10-2021
1000014586,10,1222,1259,37,05-11-2021
1000014588,1,2645,2977,332,05-02-2021
1000014588,2,2724,2977,253,05-03-2021
1000014588,3,2806,2977,171,05-04-2021
1000014588,4,2892,2978,86,05-05-2021
1000014589,1,0,664,664,05-02-2021
1000014589,2,0,664,664,05-03-2021
1000014589,3,0,664,664,05-04-2021
1000014589,4,0,664,664,05-05-2021
1000014589,5,0,664,664,05-06-2021
1000014589,6,0,664,664,05-07-2021
1000014589,7,4167,4831,664,05-08-2021
1000014589,8,4292,4831,539,05-09-2021
1000014589,9,4421,4831,410,05-10-2021
1000014589,10,4554,4831,277,05-11-2021
1000014589,11,4691,4831,140,05-12-2021
1000014598,1,0,271,271,05-02-2021
1000014598,2,0,271,271,05-03-2021
1000014598,3,0,271,271,05-04-2021
1000014598,4,0,271,271,05-05-2021
1000014598,5,0,271,271,05-06-2021
1000014598,6,0,271,271,05-07-2021
1000014598,7,1016,1287,271,05-08-2021
1000014598,8,1047,1287,240,05-09-2021
1000014598,9,1078,1287,209,05-10-2021
1000014598,10,1110,1287,177,05-11-2021
1000014598,11,1144,1287,143,05-12-2021
1000014598,12,1178,1287,109,05-01-2022
1000014598,13,1213,1287,74,05-02-2022
1000014598,14,1245,1282,37,05-03-2022
1000014599,1,895,1276,381,05-02-2021
1000014599,2,922,1276,354,05-03-2021
1000014599,3,950,1276,326,05-04-2021
1000014599,4,978,1276,298,05-05-2021
1000014599,5,1007,1276,269,05-06-2021
1000014599,6,1038,1276,238,05-07-2021
1000014599,7,1069,1276,207,05-08-2021
1000014599,8,1101,1276,175,05-09-2021
1000014599,9,1134,1276,142,05-10-2021
1000014599,10,1168,1276,108,05-11-2021
1000014599,11,1203,1276,73,05-12-2021
1000014599,12,1235,1272,37,05-01-2022
1000014624,1,1666,2836,1170,05-02-2021
1000014624,2,1716,2836,1120,05-03-2021
1000014624,3,1767,2836,1069,05-04-2021
1000014624,4,1820,2836,1016,05-05-2021
1000014624,5,1875,2836,961,05-06-2021
1000014624,6,1931,2836,905,05-07-2021
1000014624,7,1989,2836,847,05-08-2021
1000014624,8,2049,2836,787,05-09-2021
1000014624,9,2110,2836,726,05-10-2021
1000014624,10,2174,2836,662,05-11-2021
1000014624,11,2239,2836,597,05-12-2021
1000014624,12,2306,2836,530,05-01-2022
1000014624,13,2375,2836,461,05-02-2022
1000014624,14,2447,2836,389,05-03-2022
1000014624,15,2520,2836,316,05-04-2022
1000014624,16,2596,2836,240,05-05-2022
1000014624,17,2673,2836,163,05-06-2022
1000014624,18,2747,2829,82,05-07-2022
1000014625,1,0,82,82,05-02-2021
1000014625,2,0,82,82,05-03-2021
1000014625,3,0,82,82,05-04-2021
1000014625,4,0,82,82,05-05-2021
1000014625,5,0,82,82,05-06-2021
1000014625,6,0,82,82,05-07-2021
1000014625,7,2740,2822,82,05-08-2021
1000014661,1,0,573,573,05-02-2021
1000014661,2,0,573,573,05-03-2021
1000014661,3,0,573,573,05-04-2021
1000014661,4,0,573,573,05-05-2021
1000014661,5,0,573,573,05-06-2021
1000014661,6,0,573,573,05-07-2021
1000014661,7,3600,4173,573,05-08-2021
1000014661,8,3708,4173,465,05-09-2021
1000014661,9,3819,4173,354,05-10-2021
1000014661,10,3933,4173,240,05-11-2021
1000014661,11,4052,4174,122,05-12-2021
1000014662,1,916,1306,390,05-02-2021
1000014662,2,943,1306,363,05-03-2021
1000014662,3,972,1306,334,05-04-2021
1000014662,4,1001,1306,305,05-05-2021
1000014662,5,1031,1306,275,05-06-2021
1000014662,6,1062,1306,244,05-07-2021
1000014662,7,1094,1306,212,05-08-2021
1000014662,8,1127,1306,179,05-09-2021
1000014662,9,1160,1306,146,05-10-2021
1000014662,10,1195,1306,111,05-11-2021
1000014662,11,1231,1306,75,05-12-2021
1000014662,12,1268,1306,38,05-01-2022
1000014668,1,981,1242,261,05-02-2021
1000014668,2,1010,1242,232,05-03-2021
1000014668,3,1040,1242,202,05-04-2021
1000014668,4,1071,1242,171,05-05-2021
1000014668,5,1104,1242,138,05-06-2021
1000014668,6,1137,1242,105,05-07-2021
1000014668,7,1171,1242,71,05-08-2021
1000014668,8,1202,1238,36,05-09-2021
1000014671,1,1945,2773,828,05-02-2021
1000014671,2,2003,2773,770,05-03-2021
1000014671,3,2063,2773,710,05-04-2021
1000014671,4,2125,2773,648,05-05-2021
1000014671,5,2189,2773,584,05-06-2021
1000014671,6,2255,2773,518,05-07-2021
1000014671,7,2322,2773,451,05-08-2021
1000014671,8,2392,2773,381,05-09-2021
1000014671,9,2464,2773,309,05-10-2021
1000014671,10,2538,2773,235,05-11-2021
1000014671,11,2614,2773,159,05-12-2021
1000014671,12,2695,2776,81,05-01-2022
1000014674,1,1494,1784,290,05-02-2021
1000014674,2,1539,1784,245,05-03-2021
1000014674,3,1585,1784,199,05-04-2021
1000014674,4,1633,1784,151,05-05-2021
1000014674,5,1682,1784,102,05-06-2021
1000014674,6,1729,1781,52,05-07-2021
1000014675,1,0,762,762,05-02-2021
1000014675,2,0,762,762,05-03-2021
1000014675,3,0,762,762,05-04-2021
1000014675,4,0,762,762,05-05-2021
1000014675,5,0,762,762,05-06-2021
1000014675,6,0,762,762,05-07-2021
1000014675,7,2500,3262,762,05-08-2021
1000014675,8,2575,3262,687,05-09-2021
1000014675,9,2652,3262,610,05-10-2021
1000014675,10,2732,3262,530,05-11-2021
1000014675,11,2814,3262,448,05-12-2021
1000014675,12,2898,3262,364,05-01-2022
1000014675,13,2985,3262,277,05-02-2022
1000014675,14,3075,3262,187,05-03-2022
1000014675,15,3169,3264,95,05-04-2022
1000014676,1,2009,2399,390,05-02-2021
1000014676,2,2069,2399,330,05-03-2021
1000014676,3,2132,2399,267,05-04-2021
1000014676,4,2195,2399,204,05-05-2021
1000014676,5,2261,2399,138,05-06-2021
1000014676,6,2328,2397,69,05-07-2021
1000014677,1,957,1212,255,05-02-2021
1000014677,2,985,1212,227,05-03-2021
1000014677,3,1015,1212,197,05-04-2021
1000014677,4,1045,1212,167,05-05-2021
1000014677,5,1077,1212,135,05-06-2021
1000014677,6,1109,1212,103,05-07-2021
1000014677,7,1142,1212,70,05-08-2021
1000014677,8,1180,1214,34,05-09-2021
1000014678,1,0,390,390,05-02-2021
1000014678,2,0,390,390,05-03-2021
1000014678,3,0,390,390,05-04-2021
1000014678,4,0,390,390,05-05-2021
1000014678,5,0,390,390,05-06-2021
1000014678,6,0,390,390,05-07-2021
1000014678,7,2010,2400,390,05-08-2021
1000014678,8,2070,2400,330,05-09-2021
1000014678,9,2132,2400,268,05-10-2021
1000014678,10,2196,2400,204,05-11-2021
1000014678,11,2262,2400,138,05-12-2021
1000014678,12,2330,2399,69,05-01-2022
1000014679,1,2545,3039,494,05-02-2021
1000014679,2,2621,3039,418,05-03-2021
1000014679,3,2700,3039,339,05-04-2021
1000014679,4,2781,3039,258,05-05-2021
1000014679,5,2864,3039,175,05-06-2021
1000014679,6,2954,3041,87,05-07-2021
1000014680,1,981,1242,261,05-02-2021
1000014680,2,1010,1242,232,05-03-2021
1000014680,3,1040,1242,202,05-04-2021
1000014680,4,1071,1242,171,05-05-2021
1000014680,5,1104,1242,138,05-06-2021
1000014680,6,1137,1242,105,05-07-2021
1000014680,7,1171,1242,71,05-08-2021
1000014680,8,1202,1238,36,05-09-2021
